SYN0	aa,lava,missions,nts,shipmate,teammate,teammates
SYN1	aaa
SYN2	aahs,bawling,bawls,bellow,bellowing,bellows,bird,birds,boo,boos,clamor,clamoring,clarion,coo,coos,cries,cry,crying,exclaim,exclaimed,exclaiming,exclaims,gee,gees,growl,growls,holler,hollers,hoot,howl,howls,noise,noises,ooh,oohs,roar,roared,roaring,roars,scream,screamed,screaming,screams,screech,screeches,screeching,shriek,shrieking,shrieks,shrill,shrills,snort,snorts,sobbing,squall,trumpeted,trumpeting,wail,wailing,wails,weep,weeps,whimpering,whoop,whooping,whoops,yell,yelled,yelling,yells,yelps,yip
SYN3	aaron
SYN4	ab,abs,biceps,oblique,pecs
SYN5	aback
SYN6	abandon,abandoned,abandoning,abandons,desolate,disposed,ditch,ditched,ditches,ditching,dump,dumping,dumps,evacuate,evacuated,evacuates,fling,flinging,flings,flung,forgo,forgoes,jettison,jettisoned,jettisons,lam,lams,maroon,marooned,quit,quits,quitting,renounce,renounced,renounces,retired,retires,retiring,scatting,scrapped,scrapping,skies,sky,strand,stranded,stranding,strands,wasted,wastes
SYN7	abandonment,avoidance,backdown,banishment,bloodthirstiness,desertion,discard,discards,exposure,loneliness,morale,morales,optimism,partisanship,permissiveness,pessimism,physicality,proclivities,proclivity,propensity,tendencies,unwillingness,willingness
SYN8	abating,abbreviated,belittle,belittled,belittling,cutbacks,decline,declined,declines,declining,depreciated,desensitization,diminish,diminished,diminishing,dwindle,dwindled,dwindling,flag,lax,limiting,minimize,minimizing,mitigated,pare,pared,rained,raines,reduce,reduced,reduces,reducing,shortened,slack,slacker,slow,slowed,slowing,slows,subsided,tapers,undervalued,vaporize,vaporized,wane,wanes,waning,weakened
SYN9	abbe,abbots
SYN10	abc,abcs,alphabet,basics,bedrock,fundamentals,rudiments
SYN11	abdomen,apparatus,apparatuses,armpit,bellies,belly,buttocks,cavity,chest,corporation,horseback,loin,orbit,pelvis,sockets,tissue,tissues,torsos,tummy,underbelly
SYN12	abducted,attractions,cart,carted,carts,delineated,force,forces,haul,hauled,hauls,kidnap,kidnaped,kidnaping,kidnaps,outlined,outlining,pluck,plucked,plucks,plunked,shanghai,shanghaied,sketch,sketched,sketching,tug,tugs,tweaked,tweaking,tweaks,unsheathes,winches,wresting,yanked,yanking
SYN13	abduction,abductions,advancement,advancements,agitation,ascent,brandishing,careening,chase,chases,churns,coast,coasts,conquering,conquest,dart,darts,diverge,dodge,dodges,fidget,flicker,flickers,fluctuates,flutter,flutters,followings,funnel,funneled,gravitates,haste,herded,herding,inclination,ingrains,internment,jerks,jitters,jittery,jolting,kick,kicking,kicks,kidnapping,lasso,migration,moping,palpitation,pitch,pitches,pitching,prostration,quivering,rebound,recaptures,revolve,rocked,rocking,roped,scrolled,seizure,snap,snaps,span,spans,spill,spilled,spilling,spilt,squat,straddle,stream,streams,stretch,stretches,stretchs,stroke,strokes,sweep,sweeps,swinging,teeter,teetering,translation,translations,twitch,twitches,twitching,vibrations,waver,wavers,wiggles
SYN14	abel
SYN15	aberdeen
SYN16	aberration,deflection,delirium,deviance,deviation,disruption,disruptions,distortion,disturbances,gynecomastia,havoc,inversion,melee,neuroses,parallax,upheaval,warp
SYN17	abetted,abetting,protect,protecting,protects,valet
SYN18	abeyance,flatness,halt,holdup,holdups,inaction,letup,postponement,restfulness,slurry,vapor
SYN19	abhorrence,abomination,despise,despised,despises,detest,detested,detests,disgusted,disgusting,hate,hated,hates,hating,hatred,loathing,malevolence,misanthropy,misogyny,nausea,nauseated,nauseating,repulsion,revolted,revolting,revulsion,sicken,sickened,sickening,sickens
SYN20	abhorrent,abominable,abusive,charnel,creepier,creepiest,creepy,detestable,ghastly,ghoulish,hateful,hideous,horrid,lewd,morbid,objectionable,obnoxious,obscene,odious,offensive,outrageous,raunchy,repugnant,repulsive,salacious
SYN21	abides,abode,accepting,accepts,authorized,bides,brooks,countenance,endure,endured,endures,enduring,include,included,includes,including,lasted,legalized,legitimize,overstay,overstaying,overstays,paid,persist,persists,stay,stayed,staying,stays,swallow,swallowed,swallows,trust,trusted,trusting,trusts,undergo,undergoes,undergoing,undergone,underwent,visage,visit
SYN22	abilities,ability,accomplishment,accomplishments,accuracy,amorality,aptitude,badness,believability,brain,brains,capabilities,capability,capacity,clarity,claritys,competence,competency,complexities,complexity,creativeness,creativity,credibility,destructiveness,distinction,distinctions,effectiveness,elegance,equivalent,equivalents,ethnicities,ethnicity,faculties,faculty,faithfulness,fidelity,goodness,holiness,humanness,illogic,immorality,impotence,impressiveness,inability,inaccuracies,incredibility,ineptitude,ineptness,inferiority,infidelities,infidelity,inhumanity,juggernaut,jurisdiction,knowledge,limitlessness,magnate,morality,naivete,naivety,naturalness,negativity,originality,perception,perceptions,poignancy,popularity,powerlessness,powers,psyche,psyches,qualities,quality,regularity,relativity,resonance,romanticism,salability,sameness,sanctity,shrillness,simplicities,simplicity,strangeness,stranglehold,stridency,superpower,superpowers,texture,textures,timbre,tycoon,tycoons,ultimate,unfaithfulness,unoriginality,unpleasantness,unpopularity,usefulness,vibrancy,vocabularies,vocabulary,wattage,worth,wrongness
SYN23	abject,calamitous,contemptible,despondent,disastrous,downtrodden,forlorn,hapless,helpless,henpecked,hopeless,humbler,low,lower,lowest,lows,measly,meek,miserable,moo,pathetic,pitiful,regrettable,scummy,unhappy,wretched
SYN24	ablaze,afire,alight,blazing,brilliant,burning,burnings,colourful,fiery,flame,flames,flaming,iridescent,lighted,lit,passionate,psychedelic,vibrant,vivid
SYN25	ably,abnormally,abruptly,absolutist,absurdly,abundantly,actively,adamantly,adequate,adjective,admirably,adroitly,aggravatingly,aggressively,agonizingly,agreeably,agricultural,allegedly,aloof,amphibious,anal,anecdotal,anemic,anglican,antarctic,apoplectic,aptly,archival,ardently,ascetic,astronomical,atheist,austrian,bantu,baptist,belgian,bicentennial,binary,boastfully,bombastically,boringly,botanical,brashly,brazenly,breathlessly,briskly,british,brotherly,bulgarian,calmly,calvinist,cambodian,captivatingly,cardiac,carnal,catholic,ceaselessly,centennial,chaotic,chiefly,chinese,clinical,clumsily,coastal,coincidentally,comatose,comically,commendable,communist,competent,concurrently,congolese,congressional,conjugal,conspiratorial,contemptuously,cornish,cruelly,cryptically,culinary,curtly,cybernetic,czech,dalmatian,danish,decently,decidedly,defenceless,defenseless,demographic,detrimentally,diabolically,disgustedly,distressingly,disturbingly,doubly,dramaturgical,educational,electoral,elegiac,eloquently,emphatically,enchantingly,enjoyably,estrogenic,eternally,eventually,exceedingly,exceptionally,excessively,exclusively,excruciatingly,exorbitantly,exponential,expressionist,famously,fascist,fascistic,febrile,feline,fervently,fictional,fiendishly,filipino,financial,fishy,fleshy,fluently,frankly,frenetically,fully,fundamentally,gaelic,galloping,gamely,genital,geographic,geographical,giddily,glaringly,gleefully,governmental,graphical,greek,grievously,grimly,grossly,gruesomely,haggardly,haphazard,headlong,heavenly,horrifyingly,hourly,hungarian,hyperbolic,hypnotic,hypodermic,hypothetically,iambic,immensely,imperialist,impressionist,improbably,impulsively,incessantly,indian,individually,inexorably,inherently,insanely,insular,insultingly,intentionally,intently,iranian,iraqi,ironically,islamic,isolationist,italian,japanese,jocular,jointly,joyfully,jubilantly,julian,keenly,kindly,korean,labyrinthine,laconically,laughably,lebanese,leisurely,literary,lithuanian,logistical,lyric,magically,malay,marian,marital,menacingly,missionary,monthly,moroccan,mural,murkily,muslim,mysteriously,mythic,narcotic,naval,nebulous,needfully,nimbly,nocturnal,norse,numeric,nuptial,occasionally,oceanic,ominously,ordinarily,originally,pacific,pakistani,parental,parisian,parliamentary,parochial,pathological,pelvic,pencilled,pensively,perilously,personal,phallic,pharmacological,photographic,pictorial,poetical,polynesian,portuguese,positively,preconceived,priestly,problematically,prominently,properly,psychiatric,psychological,pubic,putrid,radiantly,recently,reflectively,remarkably,reptilian,residential,resoundingly,respiratory,retentive,retinal,rollickingly,romanian,roundly,royal,rudely,ruritanian,russian,satanic,scenic,scientific,scrumptiously,secretly,separately,serous,servo,sexual,sickeningly,simultaneously,snidely,softly,solely,solidly,spectral,spherical,splashy,spontaneously,stellar,strangely,stubbornly,suburban,successively,suddenly,suitably,superbly,supposedly,surely,surreptitiously,suspiciously,sweetly,symptomatic,tangential,tearfully,tediously,telegraphic,tenaciously,terminal,tersely,testicular,threateningly,tibetan,tirelessly,tiresomely,tonal,torturously,touchingly,transitional,traumatic,triumphantly,trojan,turkish,tuscan,tyrannic,unimaginatively,unspeakably,vaginal,vainly,vehemently,viciously,waxen,weakly,woefully,wordlessly,yemeni
SYN26	abnormal,atypical,bugger,buggers,degenerates,deviant,deviants,exceptional,fetishist,fetishists,freakish,irregular,irregulars,kinkier,kinky,letch,masochist,nympho,nymphomaniac,nymphos,pedophile,sadist,sadists,sadomasochists,unconventional,unpredictable
SYN27	aboard
SYN28	abolish,discarded,discarding,omit,omits,omitting
SYN29	abolitionist,abolitionists,activist,activists,conservationist,demonstrators,environmentalist,feminist,hippie,hippies,hipster,hipsters,militants,rebel,rebels
SYN30	aboriginal,aboriginals,aborigine,flemish,palestinian,palestinians,premature,primeval,primordial
SYN31	abort,aborted,abortion,abortions,anticlimactic,anticlimax,ax,axed,banish,banished,banishes,bleed,bleeding,bleeds,blow,blows,breathe,breathed,breathes,cease,ceases,choke,choked,chokes,choking,climaxing,closure,conked,culmination,death,deaths,decease,demise,demises,departure,emits,emitted,emitting,evict,evicted,exit,exits,expire,expired,expiring,famished,festering,finalized,firings,lasts,overthrow,ovulating,perish,perishes,release,releases,relinquishes,sack,sacks,spew,spewed,spewing,spews,starve,starved,starves,starving,stifle,stifled,stifles,stifling,succumbed,succumbing,succumbs,suffocates,suffocating,unleash,unleashed,unleashes,unleashing,victories,victory,windup,withdrawal
SYN32	abortionist,doc,gps,houseman,intern,physician,quack,revamped,surgeon,vet,veterinarian,vets
SYN33	abortive,stillborn,unsuccessful
SYN34	abound,abounded,abounding,abounds,accept,affluent,billionaire,birthed,boast,boasted,boasting,boasts,brim,brimming,brims,bursted,bursting,chin,collapsed,collapsing,crump,detonation,excellence,external,facet,facets,feature,features,forehead,foreheads,genial,inherit,inheriting,inherits,instigate,jowls,kitten,kittens,littered,littering,millionaire,millionaires,owned,owning,owns,persuade,persuaded,persuades,persuading,possess,possesses,possessing,shatter,shattered,shattering,shatters,westerns,wield,wielded,wielding,wields
SYN35	abraded,pureed,rasp,rasping,rubbing,rubs,scoured,scrubbed,scrubbing,scrubs,wipe,wipes
SYN36	abraham,abrahams
SYN37	abrasive,bumpy,craggy,earthy,fillings,foam,foams,grainy,gratingly,harsh,harsher,harshest,hilly,impregnation,jagged,molecules,mountainous,notched,overstuffed,paper,raspy,rehash,scratchy,shagged,shaggy,spotty,stony,stressful,textured,tweedy,undercut,undercuts
SYN38	abreast,hep,hipper,hippest,knowledgeable
SYN39	abroad,afield,foreign,overseas
SYN40	abrupt,acute,acutely,astute,brusque,choppy,confusedly,curt,disconnected,discourteous,hasty,precipitous,sharp,sharper,sharpest,sharply,shrewd,shrewdly,staccato,sudden,unforeseen
SYN41	absconded,bolt,bolts,defect,defected,defecting,defects,desert,deserted,deserting,eloped,fled,flee,fleeing,flees,gadfly,gobbles,gobbling,implode,imploded,implodes,liner,photocopied,photocopying,slapdash,soared,xerox,xeroxed
SYN42	absence,absences,ambition,deficit,disastrously,epilepsy,hooky,interim,interlude,interludes,intermission,lacked,meantime,pause,pauses,rhythm,rhythms,shortage,shortages,suspension,tightness
SYN43	absent,depart,departing,departs,devoid,disappearing,fade,faded,fades,fading,goner,lacking,missing,nonexistent,vanish,vanished,vanishes,vanishing,wither,withering,withers
SYN44	absentee,astronaut,astronauts,awol,cosmonaut,courier,couriers,expatriate,expatriates,foreigner,holidaymakers,messenger,messengers,migrant,motorcyclists,movers,outlanders,passenger,passengers,pedestrian,rider,riders,rover,tourist,tourists,trekker,trekkers,visitor,visitors,voyager,walkers
SYN45	absinthe,affable,amiable,codger,codgers,patriarchal,wormwood,wormwoods
SYN46	absolute,absolutely,absolutes,abstract,arbitrary,downright,independent,independents,infinite,sheer,straightforward,unequivocal,unquestionable,unquestioning,utter
SYN47	absolution,ambiance,ambience,automation,circumstance,circumstances,climate,comfort,condition,conditioned,conditions,darkness,desperation,difficulties,difficulty,dominance,emptiness,guilt,health,healths,hopefulness,identification,immunity,indulgence,iniquity,innocence,irradiation,laxity,mode,modes,moods,motivation,motivations,niche,nomination,nominations,normalcy,polarization,rebirth,redemption,redemptive,remission,safeties,safety,silence,silences,stipulated,tautness,tenseness,terms,virginal,virginity,whiteness,wickedness
SYN48	absolved,extricate,forgive,forgiven,forgives,forgiving,free,justified,legible,liberate,liberated,liberates,liberating,pardon,released,releasing,relieve,relieved,relieves,relieving,rid,ridding
SYN49	absorb,absorbed,absorbing,absorbs,adopt,adopted,adopting,adopts,alloy,blotted,center,centered,centers,centre,centres,coalesce,combine,combined,combines,combining,conjugated,dip,dipped,dipping,engaged,engages,engaging,engross,engrossed,engrosses,engrossing,engulf,engulfed,engulfing,engulfs,hearing,imbibed,immerse,immersed,immerses,immersing,listen,listened,listening,listens,melt,melted,melting,melts,mixes,molten,mop,occupied,plunge,plunged,plunges,plunging,pore,pores,recall,recalled,recalling,recalls,steep,steeped,suck,sucked,sucking,sucks
SYN50	absorption,abstraction,adaption,adaptions,americanization,amnesia,assimilation,attention,attentions,blooming,centering,concentration,concentrations,consciousness,crossover,curdling,curiosities,curiosity,digestion,digestions,engrossment,evolutionary,extinction,flow,flows,immersion,metabolism,metamorphosis,nutrition,preoccupation,radiation,regeneration,source,sources,stimulation,succession,synapses,uncertainty
SYN51	abstinence,celibacy,chastity,fasting,willpower
SYN52	absurd,complication,complications,farcical,foolish,harebrained,humorous,humourous,idiotic,illogical,imbecilic,inconsequential,intuitive,laughable,ludicrous,ludicrously,nonsensical,preposterous,ridiculous,ridiculously,size,sizes,unwise,visceral
SYN53	absurdities,absurdity,balderdash,buzzwords,cobblers,craziness,crock,crocks,drool,follies,folly,foolishness,hooey,humbug,inanity,incoherence,indiscretion,piffle,ridiculousness,senselessness,silliness,stupidity
SYN54	abundance,bounty,eccentricities,eccentricity,frequencies,frequency,frequencys,intervals,iq,magnitude,odds,overabundance,parameters,plenty,plentys,prevalence,probability,productivity,quantities,quantity,quantum,quotient,ratio,richness,volume,volumes,wealth
SYN55	abundant,ample,bumper,bumpers,copious,easier,easiest,easy,exuberant,galore,longest,overabundant,plentiful,rank,ranked,ranking,rich,richer,richest,riotous,thick,thicker,verdant,voluminous
SYN56	abuse,abused,abuses,abusing,affront,assail,assailing,assaulted,assaulting,attack,attacked,attacking,attacks,barrage,blindsided,bombard,bombarded,bombarding,bombing,bulldog,cocker,coddle,coddling,contempt,counterattack,cruelties,cruelty,dishonor,disregard,disregards,exercise,exercises,exercising,exploitation,footsteps,habit,habits,handle,handled,handles,handling,insult,insults,invective,mistreated,mistreats,misuse,misused,misuses,misusing,occupies,occupy,occupying,outrage,outraging,pampered,persecution,rape,raped,rapes,raping,recycling,reviled,ridicule,ripped,ripping,round,rounded,rounds,savaged,scalding,shout,shouted,shouting,shouts,sic,slang,upstaged,upstaging,usage,vilified,violate,violated,violates,violating,vitriol,whip,whipped,whips
SYN57	abuser,abusers,assailant,assailants,attacker,attackers,cheater,culprit,deceiver,deceivers,delinquent,delinquents,deserter,molester,molesters,offender,offenders,perpetrator,perpetrators,shark,sharks,shyster,sinner,sinners,slickers,trickster,truant,usurper
SYN58	abuzz,blatant,buzzing,creaking,creaky,droning,monotone,noisy,strident,thundering,uproarious,wheezy
SYN59	abysmal,deep,deeper,deepest,immeasurable,limitless,profound,unfathomable
SYN60	abysmally,atrociously,frightfully,horribly,repulsively,terribly
SYN61	abyss,gulf
SYN62	abyssinian,kitty,pussy,queen,queens,tom,toms
SYN63	academe,academia,academic,extraterrestrial,populace,public,publics,world,worlds
SYN64	academics,educator,instructor,instructors,lector,pedantic,prof,professor,professors,profs,scholarly,teacher,teachers
SYN65	academy,charities,charity,gym,gymnasium,highschool,orphanage,school,schooling,schools,secession,tech,techs,yeshiva
SYN66	accelerate,accelerated,accelerates,accelerating,acceleration,amphetamine,amphetamines,amplified,amplify,amplifying,brisk,compounded,compounding,darting,enhance,enhanced,enhances,enhancing,escalate,escalated,escalates,escalating,flaring,qualified,restrict,scudding,stipulate,swiftness,velocity
SYN67	accelerator,catalyst,catalysts,enzyme,gas,gases,gassed,ozone,pedal,throttle
SYN68	accent,accents,accentuate,accentuated,accentuates,accentuating,background,backgrounds,clicks,connote,connotes,dialect,dialects,downplaying,downplays,drawl,drawls,emphasising,emphasize,emphasized,emphasizes,emphasizing,evince,exhibit,exhibited,exhibiting,exhibits,explode,exploded,explodes,exploding,express,expressed,expresses,expressing,formulated,formulates,implied,implies,imply,implying,inflection,inflections,lilting,lisp,lisping,menaces,menacing,mispronounced,mispronouncing,patois,punctuated,punctuates,punctuating,smile,smiled,smiles,smiling,sneer,sneering,sneers,sounding,stress,stressed,stresses,stressing,twang,underlines,underscores
SYN69	acceptable,accepted,bankable,received,standard,superb,unchallenged,undisputed,unimpeachable,unquestioned
SYN70	acceptance,admiration,adoption,bosom,bosoms,championship,championships,drafted,drafting,drafts,exclusion,hardball,intolerance,irreverence,mentality,mindset,mindsets,outlook,purchase,purchases,reinforcement,tendency
SYN71	access,admittance,backdoors,batting,breakthrough,breast,breasts,codes,discover,discovered,discovering,discovers,find,finding,finds,recover,recovered,recovering,recovers,recuperate,regaining,retrieve,retrieved,retrieves,retrieving
SYN72	accessibility,affability,amity,availability,command,commands,conveniences,friendliness,gadgetry,helpfulness,timeliness
SYN73	accessible,approachable,comprehendible,comprehensible,intelligible,reachable,understandable
SYN74	accessory,apparel,array,attire,blackmailer,blackmailers,conspirator,conspirators,criminal,criminals,crystal,crystals,desperado,desperados,duds,felon,felons,furnishings,garb,garments,goon,goons,gray,grays,grey,greys,headdresses,hijacker,hood,hoodlum,hoodlums,hoods,incendiary,kidnaper,kidnapers,kidnapper,kidnappers,mafioso,makings,module,moll,moonshiner,murderer,murderers,outlaw,outlaws,parolee,parolees,raiment,rapist,rapists,recidivist,regalia,smuggler,smugglers,snatchers,stealer,supportive,thief,thiefs,thieves,thug,thugs,toughs,traitor,wear,wearing,wears,wore,worn
SYN75	accident,accidents,accompaniment,beginnings,bonanza,boom,burst,bursts,coincidence,coincidences,collapse,collapses,conclusion,conclusions,contact,contacts,contingency,convergence,crash,crashes,destinies,disappearance,disappearances,endings,error,errors,eventuality,failure,failures,fate,fates,godsend,gravy,happenings,incident,incidents,interruptions,juncture,lottery,marvel,marvels,miracle,miracles,occurrence,occurrences,outbreak,outburst,outbursts,setbacks,sounds,union,unions,wonders,wreck,wrecks
SYN76	accidental,accidentally,casual,cursory,effortless,everyday,extraneous,inadvertent,informal,nonchalant,occasional,perfunctory,unintended,unintentional,unwitting
SYN77	acclaim,acclaimed,applause,beck,beckon,beckoned,beckoning,beckons,becks,bravo,gesture,gestures,hailed,hailing,herald,heralded,heralds,nod,nodded,nodding,nods,plaudits,shrug,shrugged,shrugging,shrugs,testimonials,tribute,tributes,winking
SYN78	acclimatize,aline,attuned,focus,focused,focuses,focusing,geared,obey,obeying,obeys,sync,syncing,timed,timing,tuned,tuning
SYN79	accolade,accolades,addiction,addictions,allegory,cachet,celebrate,celebrated,celebrates,celebrating,celebrities,celebrity,cornucopia,dignified,emblems,emmy,fame,fellowship,glory,gratuities,icon,icons,identifiers,numeral,oscar,oscars,palm,palms,pledged,pledging,purity,renown,repute,ribbon,ribbons,scholarships,symbolism,token,tokens,trophies
SYN80	accommodate,accommodates,accommodating,appeased,behoove,comply,drenched,encountered,encountering,enforce,fill,filling,fills,homing,horse,horses,indulge,indulged,indulges,indulging,modulated,nurture,nurtures,obligated,oblige,obliges,power,shower,showers,sleep,sleeping,sleeps
SYN81	accommodations,adaptation,adaptations,adjustment,adjustments,advanced,advancing,alleviated,betterment,breakup,breakups,care,cares,deformation,detachment,dorm,elaboration,fluctuations,harem,heal,heals,improvement,improvements,preservation,recovery,refinement,refuge,renovation,resurgence,revival,revivals,revolution,revolutions,shakedown,shimmer,transformation,transformations,tune,tunes,village,villages
SYN82	accompanied,accompanies,accompany,accompanying,advance,advances,affiliated,allies,ally,angle,angles,ascension,associate,associates,associating,assorted,attend,attended,attending,attends,banged,beetle,beetles,billowing,blew,blowed,blowing,blown,bounced,caravan,career,careers,casted,circuit,circuits,click,colleague,colleagues,companies,companion,companions,companys,crawl,crawling,crawls,creep,creeped,creeping,creeps,crept,cruise,cruises,cruising,derail,derailed,derailing,drag,dragged,dragging,drags,drifts,embark,escort,escorted,escorting,exited,exiting,fellow,fellows,ferries,fiddle,flew,flies,flirt,flirting,flirts,float,floats,flock,flocked,flocking,flown,fly,follow,forge,forged,forges,hiss,hissed,hisses,hissing,journey,journeyed,journeying,journeys,lance,lanced,lances,lancing,locomotive,meandering,motor,pace,paced,paces,pacing,pan,panes,panned,panning,pans,playmate,plow,plows,prance,prances,prancing,preceded,precedes,preceding,progress,progressed,progresses,progressing,progression,propagate,propagated,propagating,raft,rafting,rambling,ranged,ranging,replay,replayed,replaying,resort,resorting,resorts,retreat,retreats,retrograding,ridden,ride,rides,riding,roam,roaming,roams,roll,rolling,rolls,roving,ruling,rushes,rushs,shack,shacking,shacks,shuttle,shuttles,slides,speeds,spread,spreading,spreads,spurted,spurting,steam,steaming,step,steps,stray,strays,surpass,surpassed,surpasses,surpassing,swing,swings,thread,threads,trail,trailed,trailing,trails,tram,tread,treading,treads,trek,treks,trod,trumps,trundle,underplay,underplayed,underplaying,underplays,wander,wandered,wandering,wanders,weave,weaves,weaving,wheel,wheeling,wheels,whine,whines,whining,whisk,whisked,whisking,winded,winding,woven
SYN83	accomplice,accomplices,aid,aide,aided,aides,aids,alleviate,alleviates,angel,angels,assistance,assistant,assistants,assisted,assisting,attendant,attendants,auxiliary,avail,backers,benefactor,benefactors,bondsman,bondsmen,bootstraps,collaborator,confederate,deputies,deputys,dixie,encouragement,enforcer,facilitate,facilitated,facilitates,godfather,godfathers,helped,helper,helping,helps,henchman,henchmen,lieutenant,lieutenants,patron,patrons,pawn,pawns,prompter,protagonist,recourse,savior,saviors,southern,southerner,souths,subordinate,subordinates,subsidiaries,subsidiary,supporter,supporters,uncle,uncles,underling,underlings
SYN84	accomplish,accomplished,accomplishes,accomplishing,achieve,achieved,achieveing,achieves,achieving,aftereffects,attain,attained,attaining,attains,breasted,complete,completed,completes,completing,consummate,culminate,culminates,culminating,disappear,disappeared,disappears,dispatches,finish,finished,finishes,finishing,fulfills,fulfils,implement,implemented,implementing,induce,induced,induces,inducing,manage,managed,manages,managing,pegged,quell,reach,reached,reaches,reaching,satisfying,slake,succeed,succeeded,succeeds,suffice,win,winning,wins,won
SYN85	accord,accordance,adhere,adhered,adheres,administered,administering,agree,agreed,agreeing,agreement,agreements,agrees,align,aligned,assent,award,awards,befitting,blend,blended,blending,blends,check,checked,checking,checks,conformity,consensus,convention,conventions,correlate,correlated,correlates,jibe,matched,matches,matching,meet,meeting,meets,met,pact,patterned,peace,resemble,resembled,resembles,resembling,rhyme,rhymes,square,squared,squaring,treaty
SYN86	accordion,harmonica,harp
SYN87	accost,accosted,accosts,address,addressed,addresses,addressing,approach,approached,approaches,approaching,arrive,arrived,arrives,arriving,ascend,ascended,ascends,cum,discourse,emanate,emanated,emanates,emanating,litany,lobbying,nearing,nears,preachings,resurface,resurfaces,resurfacing,roundhouse,semen,sermon,skyrocketed,skyrocketing,snarf,specials,thieve,thieveing,url,welles
SYN88	account,accounted,accounts,acquainted,acquaints,histories,history,reason,reasons,record,recorded,records,taped
SYN89	accountability,fault,prerequisite,reliability
SYN90	accountable,liable,responsible,trustworthy
SYN91	accountant,accountants,agent,agents,auditor,bookkeeper,bourgeois,broker,brokers,businessman,businessmen,businesswoman,businesswomen,entrepreneur,entrepreneurial,governor,governors,joystick,materialistic,merchant,merchants,nazis,supplier
SYN92	accumulate,accumulated,amass,amassed,bale,bales,cache,chunk,chunks,collect,conglomerate,corral,corralled,drift,drifting,garner,garners,gathered,gathers,hive,lump,lumps,pearl,pearls,scrape,scraped,scraping,scratch,scratched,scratches,scratching,stash,stored,summons,warehouse
SYN93	accumulation,addition,additions,ana,assembly,assortment,batch,boost,boosts,bunch,bundle,bundles,class,classes,cleanup,combination,communities,community,crop,ensemble,europe,europes,exaggeration,exaggerations,flagging,gang,gather,gathering,heighten,heightened,heightening,heightens,humanity,humans,inclusion,inclusions,killings,law,laws,legal,mass,masses,mixture,mixtures,multitude,multitudes,package,packages,parcel,procession,processions,relaxation,rise,rises,summations,traffic,universes,upsurge,varieties,variety,waxing
SYN94	accurate,accurately,admittedly,faithful,honest,precise,straightest
SYN95	accursed,blasted,cursed,damn,damned,damnedest,darned,execrable,goddam,goddamn,goddamned,loathe,loathed,loathes
SYN96	accusation,accusations,accuse,accused,accuses,accusing,affirmation,affirmations,ailment,ailments,allegations,authorizes,blame,blamed,blames,blaming,burden,burdened,consigned,grievances,hospitalised,hospitalized,hospitalizes,imprecation,indictment,institutionalize,institutionalized,levied,levy,levying,levys,overburdened,postage,reload,reloading,taxed,tithe,tutelage,whimper,whimpers
SYN97	accuser,argumentative,crusader,crusaders,reformer,reformers
SYN98	accustomed,acquire,acquired,acquires,adapt,adapted,adapting,addict,addicted,addicts,adorn,aged,ageing,aggravated,aggravating,aging,alien,alienate,alienated,alienates,alienating,aliens,alteration,alterations,amended,amends,antique,bettered,betters,blinding,camped,camping,cashing,chord,chords,civilised,civilized,concentrated,contaminated,contract,contracted,contracting,contracts,corrupt,corrupted,corrupting,crackle,crackles,crackling,cried,customary,damages,debased,decay,decayed,decaying,decreased,decreasing,deflate,deflated,delapidated,delay,delayed,demoralised,demotion,depraved,depress,depressed,depresses,depressing,disabled,disaffected,dismiss,dismissed,dismisses,dismissing,dizzy,dope,energized,equaled,equaling,equate,equated,equates,equating,exasperating,expand,expanded,expanding,expands,fats,freezing,glamorized,grime,habitual,hardened,hid,hidden,hide,hides,hiding,hue,hues,humble,humbled,immortalised,immortalized,immortalizing,impacted,impacting,improved,incapacitated,inflated,inseminates,inveterate,lacing,legitimate,lessen,lessened,liquefied,looses,loosing,lowered,lowering,lowers,market,marketed,marketing,markets,mature,merge,merged,merges,merging,mix,mixed,mixing,modernize,muddies,muddy,mutated,mutates,narrowed,nick,nicks,pall,personalized,pervert,perverted,plump,plumped,profane,proof,ready,refined,reform,reformed,reforming,reforms,refreshing,remodeled,restore,restored,restores,restoring,retarded,revolutionized,saturated,shorten,shortens,smut,sober,soil,specialised,specialize,specialized,specializes,specializing,spike,spikes,sputter,sputtering,sputters,stain,stained,staining,subdue,subvert,subverted,subverts,suffuse,supple,synthesize,synthesized,taught,teach,teaches,teaching,tempered,terminate,terminated,terminating,thickened,touched,touching,transitioning,translate,translated,translates,translating,united,update,updated,updates,usual,veil,veiled,visualised,visualize,visualized,visualizing,void,voids,vulgarize,weaken,weakening,weakens,womanized,womanizing,worsening
SYN99	ace,aces,adept,adepts,champion,champions,eagle,eagles,fantastic,genius,geniuses,hit,hits,hitting,homer,homers,hotshot,maven,monas,par,scores,sensation,sensations,service,services,single,singles,singleton,singletons,smash,smashes,super,superior,superstar,superstars,unity,virtuoso,whiz,wizard,wizards
SYN100	acerbic,acid,acidic,blistering,caustic,deadlier,deadly,destructive,scathing,sultry,toxic,unpleasant,venomous,virulent
SYN101	acerbity,acrimonious,acrimony,bitter,contentiousness,resentful,sour,soured,souring
SYN102	ache,afflicted,agonies,agonizing,agony,ailing,anguish,anguished,anguishes,biting,bitten,burn,burns,die,died,dies,divines,dying,excruciating,hallucinates,harm,harms,languishing,long,nuisance,pain,pained,pains,pine,pines,pining,rawness,sensing,sighted,smart,smarter,smartest,smartness,smarts,sting,stings,suffering,sufferings,torment,torments,torture,tortured,tortures,torturing,twinge,yen
SYN103	achievable,attainable,conceivable,feasible,manageable,workable
SYN104	achievement,achievements,acquisition,action,actions,activities,activity,alienation,choices,deed,deeds,economy,enlisting,exploit,exploits,feat,feats,goings,inhibition,inhibitions,interaction,interactions,kindness,liberation,literacy,masterpiece,masterpieces,option,options,performance,performances,pickings,recruitment,resistance,salesmanship,savings,selections,showmanship,skill,skills,smooths,squeak,swordplay,transfusions,transgression,transgressions,vampirism
SYN105	achilles
SYN106	acknowledge,acknowledged,acknowledges,acknowledging,admit,admiting,admits,admitted,admitting,answers,bastardised,bastardizing,bristling,certified,commune,communicate,communicates,communicating,confess,confesses,confessing,consent,consenting,discern,discerned,display,displayed,displaying,displays,greet,greeted,greets,heralding,honor,honored,honoring,honors,honour,honours,housed,implanted,marveled,marveling,marvelling,notice,noticed,notices,noticing,overreacts,professed,recognise,recognize,recognized,recognizes,recognizing,refuse,refused,refuses,refusing,relayed,resign,resigned,resigning,resigns,reveal,revealed,revealing,reveals,saint,saints,saluting,slept,speak,speaking,speaks,spoke,spoken,squeal,squealed,squeals,thanking,welcoming
SYN107	acknowledgeable,distinctive,identifiable,recognisable,recognizable
SYN108	acknowledgement,acknowledgment,acquiescence,admission,asides,complacent,condolences,connotations,content,contented,contents,credence,credits,digressions,disapproval,disrespect,drivel,entries,entry,essence,essences,gist,greeting,heresy,hokum,humor,humors,humour,humours,ignorance,import,imports,instruction,instructions,kernel,kernels,lore,meaninglessness,meanings,meat,messages,narrative,narratives,offerings,opinion,opinions,ovation,proposal,proposals,receipt,receipts,refusal,regrets,reminder,reminders,shocker,significance,smug,submission,substance,substances,tale,tales,telegram,tradition,traditions,unbelief,undercurrent,undercurrents,wherewithal,wit,wittiness
SYN109	acme,apex,brow,caliber,calibre,ceiling,ceilings,climax,climaxes,crown,crowns,degree,degrees,extreme,extremes,grade,grades,height,intensity,maximum,minimum,minimums,moderation,peak,peaks,pinnacle,pinnacles,summit,superlative,tips,top,tops
SYN110	acne,arthritis,hickey,pimple,pimples
SYN111	acquaintance,acquaintances,actor,actors,admirer,admirers,adult,adults,adventurer,adversaries,adversary,affiliations,affinity,african,africans,agnostic,agnostics,amigos,antagonist,antagonists,anti,ape,applicant,applicants,appointment,asthmatic,balance,balances,battler,beard,beards,bedfellows,beholder,bereaved,bests,blond,blonde,blondes,boomer,boomers,brethren,brother,brothers,brunet,brunette,brunettes,buddies,buddy,buddys,bull,buster,cancer,candidate,candidates,capitalist,captor,captors,case,cases,cashier,casualness,caucasian,censors,chameleon,charmer,child,children,childs,classmate,classmates,collector,collectors,combatants,commoner,comrade,comrades,confidant,consanguinity,contemplative,contestant,contestants,controller,controllers,coward,cowards,crab,crabs,creature,creditors,creeper,creepers,cripple,cronies,crony,database,deathly,deceased,departed,dresser,dupe,dupes,entertainers,equal,equals,ethnic,expert,explorer,explorers,face,faces,fact,facts,familiarity,female,females,fish,fishes,flatmate,forerunner,friend,friends,friendship,friendships,fugitive,fugitives,gambler,gamblers,gatekeeper,gay,gays,gem,gems,gen,gentile,goat,goats,groaner,grownup,grownups,hater,haters,hebrew,hebrews,heterosexual,heterosexuals,homeboy,homeboys,homosexual,homosexuals,huggers,image,images,imitators,immune,info,information,innocent,innocents,intellect,intellectual,intellectuals,intelligence,jew,jewels,jewish,jews,killer,killers,kink,kinks,knockers,laugher,laughers,lefty,leftys,leo,leos,libra,linguists,lion,lions,literate,longer,malcontents,male,males,man,manipulator,mans,married,marrieds,masturbator,match,mediocrity,membership,men,mice,modern,mortal,mouse,mouses,namesake,namesakes,nationals,native,natives,neighbor,neighbors,neighbour,neighbours,nondescript,nonmembers,observers,optimists,orphan,orphans,ostrich,outdoorsman,owner,owners,pansexual,passer,peer,peers,personage,personification,picker,pickers,planner,planners,possessors,propaganda,proponents,prospect,prospects,protester,protesters,quarter,quarters,ram,rams,realist,realists,redhead,redheads,rescuers,romper,roomie,roommate,roommates,ruler,rulers,schoolmates,scientist,scientists,searchers,secrets,shaker,showman,sidekick,sidekicks,slave,slaves,slayer,slayers,sliders,sort,sorts,soul,souls,sphinx,spoiler,spoilers,stifler,stiflers,straight,straights,success,successes,survivor,survivors,sweater,sweaters,threat,threats,tiger,tigers,transvestite,transvestites,traveler,travelers,traveller,travellers,trier,twin,twins,tyrant,unfortunate,unfortunates,user,users,victim,victims,victorian,virgin,virgins,virgo,waiter,warrior,warriors,watcher,watchers,weakling,white,whites,winner,winners,witness,witnesses,worker,workers,yawner
SYN112	acquit,acquits,acquitted,act,acted,acting,acts,anticipate,balanced,balancing,bear,bearing,bears,bore,born,borne,bruin,carried,carries,carry,carrying,circles,clear,clearer,clicked,clicking,confined,confines,confining,contained,conveyed,conveying,conveys,convict,convicted,convicting,convicts,cope,copes,coping,counteract,court,courts,cradling,dallied,dally,deal,dealing,deals,dealt,deported,descended,descending,descends,disqualified,ejected,ejecting,engage,environs,exert,exerts,exonerated,exonerating,expel,expelled,expelling,flap,flaps,flustered,forcing,gestate,guarded,guarding,hasten,hurried,hurtle,hurtling,impress,impressed,impresses,impressing,interact,interacted,interacting,interacts,intones,intoning,jerk,jerked,jerking,joking,jolt,jolts,keeping,label,labeled,labeling,labelled,labelling,labels,lunges,lurch,lurches,migrate,migrated,migrates,migrating,netted,netting,participate,participated,participates,participating,perpetrated,porting,pounded,pronounce,pronounced,pronounces,pronouncing,propel,propelled,propelling,propels,purge,purged,purging,qualifies,qualifying,race,races,rampage,rampages,rampaging,rang,relocate,relocated,relocates,relocating,repay,respond,responded,responding,responds,retain,retained,retaining,retains,rolled,romanced,romancing,rounding,ruled,rung,rush,rushed,rushing,seesaws,shackled,shackles,sittings,slide,sliding,snapped,snapping,speed,spurts,squirm,stampede,stampeding,stockpiling,stooge,stooges,surround,surrounded,surrounding,surrounds,swashing,swayed,swaying,touted,touting,toying,vindicated,volunteer,volunteering,volunteers,whooshed,wobbles,woo,wooed,woos
SYN113	acquittal,condemnation,sentences
SYN114	acres,ar,barn,barns,countries,country,countrys,em,empire,empires,entails,estate,estates,freehold,homestead,inch,inches,kingdom,land,lands,manor,manors,nation,nations,plantation,plantations,realm,realms,rod
SYN115	acrobat,acrobats,amateur,athlete,athletes,gymnasts,hooker,hookers,jock,jocks,letterman,lettermans,professional,runner,runners,skater,striker,suspensor,swimmer,swimmers,winger
SYN116	acrobatic,activated,active,agile,hyperactive,muscular,nimble,sporty,spry
SYN117	acrobatics,ballistics,breakout,exodus,flight,flights,flying,flyover,getaway,glide,glides,jailbreak,nonstop,tailspin,trajectory
SYN118	acronym,bunching,genus,kinds,signifiers,singular,species
SYN119	acrylic,airbrushed,camo,camouflage,coating,cord,cords,diaper,diapers,duck,ducks,duffel,duffle,jean,jeans,knit,knits,lace,laces,lint,mackintoshs,marseilles,mesh,meshes,metallic,motley,net,network,networks,painted,panting,plush,polyester,print,prints,quilting,railings,repaint,sacking,screenings,shag,shags,sharkskin,silk,tammy,tapestry,terry,terrys,ticking,tweed,velvet,web,wool
SYN120	actress,actresses,animator,animators,bowler,bowlers,doer,golfer,ham,hams,mime,participant,participants,powerhouse,powerhouses,principals,star,starlet,starlets,stars,trumpeter
SYN121	actual,concrete,effective,factual,genuine,literal,real,tangible,true,truer,truest
SYN122	actualisation,actualization,conceptualization,fruition,invention,inventions,recognition
SYN123	actuality,beings,clone,clones,cosmic,cosmos,crossbreed,eternity,existence,existences,genuineness,hybrid,individual,individuals,mascot,mortals,organism,organisms,possibilities,possibility,presence,presences,realities,reality,somebodys,someones,throwback,timelessness
SYN124	actualizing,argue,argued,argues,arguing,assemble,assembled,assembles,assembling,begets,begotten,belies,bootleg,bootlegged,bootlegging,bred,breeding,causing,choreograph,choreographed,choreographing,cleave,cleaves,compile,compiled,construct,constructed,constructs,copied,copies,copy,copying,depict,depicted,depicting,depicts,derive,derived,derives,deriving,distilled,distilling,earned,earning,earns,embodied,emote,emoting,enact,enacts,engenders,epitomizes,fashioned,fashioning,fathered,filming,froth,gained,gaines,gaining,graph,grosses,incorporate,incorporated,incorporates,incorporating,map,mapped,mother,mothering,mothers,motivate,overdo,overdoes,overdone,paint,paints,pay,payed,paying,pays,portray,portrayed,portraying,portrays,prefabricated,presented,presenting,presents,printed,printing,procreate,procreating,produces,profiling,prompted,prompts,pulsates,pulsating,pulse,pulsing,puncture,puncturing,realise,realised,realises,realising,realize,realized,realizes,realizing,rebuild,rebuilding,recreate,recreated,recreates,recreating,reinvent,reinvented,reinventing,reinvents,remade,remake,remakes,remaking,represented,representing,represents,reproduce,reproduced,reproduces,silhouette,silhouetted,silhouettes,sired,spawn,spawned,spawns,symbolise,symbolised,symbolises,symbolize,symbolized,symbolizes,symbolizing,typified,typify,wreak,wreaked,wreaking,wreaks
SYN125	acuity,detect,detects,eyesight,intelligences,optic,reconnaissance,sight,sighting,sights,spying,vision,visions,visual,wits
SYN126	acumen,guile,objectivity,subjectivity
SYN127	acupuncture,enlargement
SYN128	ad,ads,advertisement,advertisements,bills,blurb,broadside,buildup,circular,commercials,endorsement,endorsements,hoopla,hype,mailer,mailers,packaging,plug,plugs,preview,previews,prevue,promotion,promotions,publicity,teaser,teasers,throwaway,throwaways,trailer,trailers
SYN129	adage,ambiguities,ambiguity,anatomical,chainsaw,chainsaws,colloquialisms,congratulations,diction,epigrams,expression,expressions,idioms,jigsaw,maxim,maxims,motto,proverb,proverbial,proverbs,quips,saws,sayings,slogan,slogans
SYN130	adagio,adequately,adrift,arrangement,arrangements,choreography,composition,compositions,duet,duets,duo,fantasia,fragments,impromptu,mambos,medley,modulation,opus,pastiche,pastiches,pastoral,pieced,piecing,quartet,realisation,realization,realizations,sextet,sextette,slower,slowest,solo,solos,suites,trio,variation,variations
SYN131	adam,adams,chugging,chugs,circled,circling,clanking,cristal,ecstasy,err,errs,faring,floated,gurgle,misfired,overflying,ping,pink,rapture,resonate,resonated,resonates,resound,resounding,ski,skis,slither,slithering,slithers,sped,speeding,strayed,straying,swim,swimming,swims,swishes,swishing,ticked,tings,tinkling,whizzing,xtc
SYN132	adaptable,elastic,flexible,impressionable,placeholders,universal,universals
SYN133	adapters,appliance,appliances,autopilot,cellist,composer,composers,conductor,constraints,contraceptive,contraption,contraptions,converter,coordinator,coordinators,crusher,damper,detector,extinguisher,flutist,gadget,gadgets,guitarist,harper,harpers,instrumental,keyboard,keyboardist,magnet,mnemonic,organizer,pacifier,pianist,piper,rapper,rappers,saxophonist,singer,singers,violinist,vocalist,vocalists,warmers
SYN134	add,added,adding,adds,adjust,adjusting,adjusts,affect,affected,affecting,affects,aggravate,alter,amount,amounted,amounting,amounts,answer,answered,answering,ash,ashes,ashs,automated,average,bestow,bestowed,blinded,budgeted,caused,cipher,ciphers,clarified,clarify,commercialize,concentrate,concentrates,contributing,cooking,count,counted,counting,counts,create,created,creates,creating,damage,damaging,darkened,deactivating,decrease,decreases,deepened,deepening,deepens,depersonalized,differentiate,differentiated,differentiates,differentiating,digitalized,digitized,dirtied,disable,disintegrate,disintegrated,disintegrating,divided,divides,dizzying,dull,elaborate,elaborated,elaborating,enable,enabled,enables,enabling,energize,equalizes,eroticize,exacerbated,exacerbates,factor,factored,factors,gain,gains,gauge,glamorise,glamorising,glamorize,humanize,humanized,humanizes,humanizing,impart,imparted,imparting,imparts,incapacitate,increase,increased,increases,increasing,inflate,inflating,instill,instills,insulated,integrate,integrated,integrating,intensifies,introverted,landing,lend,lending,lends,lent,lessening,matured,matures,maturing,mingle,miscalculated,morph,morphed,morphing,morphs,multiplied,multiplies,multiply,multiplying,number,numbered,numbers,outnumber,overcloud,personalizes,preface,prefacing,produce,produced,producing,recount,recounting,recounts,redoing,redone,reestablishing,refreshed,regenerated,replied,resolve,resolved,resolves,resolving,romanticise,romanticising,sanitises,saturating,sexualize,sexualized,shallow,simplified,simplifies,simplify,solve,solved,solves,solving,strengthening,subtract,sum,summarize,summarized,summarizes,summarizing,summed,summing,sums,sweeten,sweetens,tally,tighten,tightened,tightens,total,totals,tots,unfitting,updating,vocalized,westernized
SYN135	addendum,affair,appended,atom,atomic,continuation,digestive,elixir,food,foods,goo,gook,gunk,mattered,precursor,ps,slime,slimes,sludge,supplement,supplementing,weighed,weighing,weighs
SYN136	addictive
SYN137	additional,additive,complementary,cumulative,redundant,supererogatory,superfluous,surplus,unnecessary,unneeded
SYN138	additionally
SYN139	addled,curdled,jumbled,muddle,muddled,muddling,puddle,rummages,spoiled,spoiling,spoils,stale,woolly
SYN140	ade,alcohol,beverages,chocolate,cider,coffee,drank,drink,drinking,drinks,gulp,gulped,guzzling,lemonade,mate,mates,milk,milks,milkshake,mixer,mixers,pledges,potion,potions,sip,sipes,sipping,swill,toast,toasts,wining
SYN141	adelaide
SYN142	adeptness,celerity,deftness,dexterity,efficiency,expertise,forum,forums,immediacy,mastery,proficiency,rapidity,restroom,sleight,technique,techniques,versatility
SYN143	adherence,affirm,aiding,apologize,apologizes,apologizing,approval,basement,befriend,befriended,befriending,befriends,bond,bonding,bonds,championing,dangling,enslaved,frequents,handcuff,handcuffs,ligaments,livelihoods,soldering,stairs,welding
SYN144	adherents,apostle,apostles,chaser,chasers,cultist,disciple,disciples,flunky,follower,followers,jungian,parasites,planet,planets,pursuer,pursuers,rastafarian,rastafarians,regulars,tagalong,tao,totalitarian,wagnerian
SYN145	adhesive,cohesive,fiber,fibers,gooey,hazmat,icky,insulators,lubricants,mineral,paste,pastier,pasties,pasty,stuff,stuffed,stuffing,stuffs,tenacious,viscous
SYN146	aditi
SYN147	aditya,avatar,dharma
SYN148	adjacent,adjoining,ambient,approximate,boon,chummy,close,closed,closer,closes,closest,closing,coda,codas,connected,epilogue,epilogues,finale,finales,imminent,nearby,neighboring,neighbouring,secretive,shut,shuts,shutting,succeeding
SYN149	adjectives,intensive,modifier,noun
SYN150	adjuster,coroner,detective,detectives,examiner,experimenters,inspector,inspectors,investigator,investigators,researcher,researchers
SYN151	administration,administrative,affiliate,alignment,alignments,alliance,alliances,bench,benches,brotherhood,bureaucracy,coalition,colonization,company,constituency,constitution,delegation,disposal,distribution,drugging,empowerment,establishments,federation,federations,fiefdoms,finance,formation,hierarchies,hierarchy,institution,institutions,judiciary,justice,misconduct,misdirection,mission,ngo,organisation,organisations,organization,organizations,oversight,personnel,settlement,supervising,supervision,system,systems,tenure,treatment,treatments,troupe,university,universitys
SYN152	administrator,captained,chairman,chancellor,commissioner,director,directors,don,dons,executive,executives,fellatio,foreman,general,generals,head,headmasters,heads,honcho,honchos,manager,managers,pothead,potheads,problem,problems,rainmaker,rubrics,secretaries,secretary,secretarys,subconscious
SYN153	admirable,delicious,delightful,fab,faber,fabulous,ingratiating
SYN154	admiral,admirals,emperor,emperors,viceroy
SYN155	admire,admired,admires,admiring,booty,cost,costs,deference,esteem,esteemed,estimation,eyeball,eyeballed,eyeballs,fronted,fronting,gawking,gaze,gazed,gazes,gazing,glances,goggles,gratuity,homage,homages,importance,jackpot,jimmies,jimmy,jimmys,leered,leering,levers,lionize,lionized,lionizing,ogle,ogled,ogling,overestimated,peeking,peering,price,prices,prize,prized,prizes,prospected,prospecting,pry,prying,reassess,reassessed,respected,respecting,revere,revered,reverence,scholarship,staring,stature,treasure,treasured,treasures,trophy,values,venerated
SYN156	admonition,advice,berated,berates,castigates,caveat,chastised,chastising,chides,earful,lambasted,lecture,lectured,lectures,lecturing,lesson,lessons,premonition,rebuked,rebukes,reprimand,reprimands,scold,scolding,scolds,speech,speeches,trounced,warnings
SYN157	ado,budge,bustle,bustling,churn,churned,commotion,din,dither,electricity,flurry,hustle,hustled,hustles,hustling,ruckus,turmoil,uproar,wanking,whetted
SYN158	adolescence,adulthood,age,ages,childhood,childhoods,deathbed,eighties,forties,immaturity,infancy,maturity,nineties,puberty,seventies,sixties,thirties
SYN159	adolescent,adolescents,boyish,formative,girlish,immature,infantile,jejune,juvenile,juveniles,minors,mod,newborn,preteen,puerile,punk,punks,rocker,rockers,teen,teenage,teenaged,teenager,teenagers,teens,young,younger,youngest,youngster,youngsters,youth,youthful,youths
SYN160	adopter,maternal,parent,parenting,parents,paternal
SYN161	adoptive,deputy,foster,fostered,fosters
SYN162	adorable,adorably,angelic,cherubic,cuddly,lovable,loveable,loveliest,lovely
SYN163	adorableness,allure,attraction,attractiveness,charisma,fascination
SYN164	adoration,adore,adored,adores,adoring,agape,appreciation,cherished,doted,glorification,heartstrings,idolising,idolize,idolized,idolizes,idolizing,lovemaking,vogue,wonderment,worship,worships
SYN165	adorned,adorning,altered,altering,braided,clad,clothed,color,coloring,colors,colour,colours,deck,decked,decks,decorated,embellish,embellished,embroidered,feathered,feathery,graced,jewel,laced,mosaic,ornate,paneled,paneling,suited,trim,trimmed
SYN166	adornments,bauble,brass,centerpiece,centerpieces,decor,emblazoned,filleted,frills,frontals,gargoyles,garnish,graffiti,jewelry,knob,landscaping,medal,nonsense,pectorals,redecorating,rosette,stud,studs,tassel,tassels,tattoo,tattoos,trimming,trimmings,trinket
SYN167	adrenalin,adrenaline,coldness,hormone,hormones,insulin,nicotine,steroid,steroids
SYN168	adrian
SYN169	adroit,artful,bathe,bathed,bathes,clever,cleverest,convenient,crafty,cunning,cute,deft,dexterous,dextrous,dodgy,foxy,handy,ingenious,manipulative,neat,neater,sly,uninfected,wily
SYN170	adulation,coaxing
SYN171	adulterer,dissolute,fornicators,gigolo,philanderer,rake,rip,rips,rounder,rounders,seducer,slut,swingers,violator,violators,womanizer
SYN172	adulterous,cheating,extracurricular,extramarital,illicit,treacherous,unfaithful,untrue
SYN173	adultery,fornication
SYN174	advantage,advantages,asset,assets,benefit,benefited,benefits,clout,cracker,crux,cusp,deadline,expediency,extent,extents,favor,favored,favors,favour,favours,focal,gunpoint,midair,midpoint,minutiae,opt,opted,opting,opts,preference,preferences,preferred,privilege,privileged,privileges,profit,profiteers,profits,reinforce,resource,resources,reward,rewarding,rewards,technicalities,technicality,wbn,welfare,wellness
SYN175	advent,arrival,arrivals,autumn,autumns,comer,comers,harden,homecoming,noel,orgasm,orgasms,season,seasoned,seasons,spiced,springtime,summers,summertime,winters
SYN176	adventure,adventures,ante,assignment,assignments,attempt,attempted,attempting,attempts,babies,baby,babys,breezes,effort,efforts,endeavor,endeavored,endeavors,endeavours,enterprise,enterprises,gamble,gambled,grope,jeopardize,jeopardy,labor,labored,laboring,labors,labour,laboured,labours,marathon,peril,perils,picnic,projected,projecting,risk,risked,risking,risks,strive,strived,strives,striving,strove,tasks,test,tests,travails,trys,undertaking
SYN177	adventurous,audacious,bodacious,darings,intrepid,swaggering,swashbuckling,temerity
SYN178	adverse,adversely,disadvantageous,harmful,inauspicious,injurious,minus,noxious,ominous,perverse,wayward
SYN179	adversity,affliction,distress,hardship,hardships,misadventure,misadventures,mishap,mishaps,nadir,pities,pity,sewer,sewers,toilet,toilets,weakness,weaknesses
SYN180	advertise,advertised,advertising,agitate,aired,aires,airing,applaud,applauded,applauding,ballyhoo,ballyhooed,baring,compliment,complimented,denounce,denounced,denounces,denouncing,eulogy,extols,flattered,flattering,furthering,furthers,harbinger,kudos,lauded,meld,melding,nudge,plugged,plugging,praise,praised,praises,praising,promote,published,publishing,recommendation,shove,shoved,shoving,sonnets,topple,toppled,topples,toppling,trump,trumping
SYN181	advertiser,booster,huckster,hucksters,promoter,promoters,sensationalist
SYN182	advil
SYN183	advisable,weller
SYN184	advise,advised,advises,advising,advocate,advocated,advocates,advocating,alluded,alludes,announced,announces,announcing,appreciated,appreciates,appreciating,apprise,briefed,chaired,confer,conferring,confers,consult,consulted,consulting,counsel,counseling,counsels,cued,deconstruct,deconstructed,deconstructing,deconstructs,deliberate,deter,discourage,discouraged,discouraging,discuss,discussed,discusses,discussing,dissuade,dissuaded,familiarize,hinted,hinting,indicating,inform,informed,informing,informs,instruct,instructed,instructs,misguided,narrate,narrated,narrates,narrating,negotiate,negotiates,negotiating,notifying,proposition,propositioned,propositions,recommend,recommended,recommending,recommends,remind,reminded,reminding,reminds,suggest,suggested,suggesting,suggests,testify,testifying,understate,understates,urge,urged,urges,urging
SYN185	adviser,advisers,advisor,advisors,confidence,connoisseurs,consultant,consultants,counsellor,counselor,counselors,distributor,distributors,lordship,pacha,professionals,touts
SYN186	aerial,airy,antenna,ethereal,insubstantial,message,relay,shadowy,stringy,unsubstantial
SYN187	aerospace,air,airs,backwater,baddie,baddies,county,demesne,depth,depths,detach,disassociates,disconnect,disconnecting,disconnects,district,divide,dividing,divorce,divorced,divorces,divorcing,domain,exterior,exteriors,extremity,fragment,heartland,heavies,hell,hellhole,hunk,hunks,inferno,ingenue,inside,insides,interior,interiors,laboratory,layer,layers,mansion,mansions,mare,maria,neighborhood,neighborhoods,partly,persona,personas,polarize,polarized,polarizes,polarizing,radius,regions,role,roles,ruptured,sections,separating,sever,severs,splitting,theater,theatre,upstage,vacuum,villain,villains
SYN188	aesthetic,aesthetically,aesthetics,animalistic,beautiful,creed,deconstruction,dialectic,ethical,existentialist,humanism,ideal,idealistic,mechanism,mechanisms,metaphysical,naturalism,nihilistic,painterly,philosophies,philosophy,pleasing,pragmatic,realism,realistic,satisfyingly,sensationalism,sensuous,solipsism,tasteful,transcendental
SYN189	affairs,borrowing,borrowings,ceremonial,commerce,commercial,dealings,fluids,function,functioned,functioning,functions,fundraiser,fundraisers,intimacy,involvement,jubilation,matter,matters,observance,occasion,occasions,parties,party,partys,rentals,renting,transaction,transference
SYN190	affectation,affectations,attitude,attitudes,guise,guises,hypocrisy,idiosyncrasies,mannerisms,masquerade,masquerading,posturing,pretense,pretenses,pretext
SYN191	affection,affections,amazement,ambivalence,astonishment,belief,beliefs,bravery,creepiness,despair,dislike,dislikes,emotion,emotions,feelings,fondness,happiness,heart,hearts,humility,intuition,levity,mettle,mood,pang,pangs,pleasance,regard,respect,respects,sadness,sympathies,sympathy,tenderness,unhappiness,warmth
SYN192	affectionate,affectionately,amorous,ardent,batman,batmans,bellboy,bellboys,bellhop,caddies,caring,doting,enthusiastic,esquire,esquires,fatherly,fond,fonder,fondest,gaga,orderly,page,pages,tender,tenderly,warm,warmer,warmest,warming
SYN193	affirmative,favoring,optimistic,positive,professing,profession,professions,yea,yeas
SYN194	affirming,affirms,alleged,assert,asserted,asserting,asserts,assure,assured,assures,assuring,attest,attests,avowed,back,backed,backing,backs,bedpost,bookend,bookends,bracket,condemn,condemns,confirming,corroborated,declare,declared,declares,declaring,defending,demonstrate,demonstrated,demonstrates,demonstrating,document,documented,documenting,documents,hanger,hangers,incarnate,justifies,justify,justifying,maintained,plead,pleaded,pleading,pleads,poled,proclaim,proclaimed,proclaiming,proclaims,profess,professes,prop,props,protest,protesting,protests,prove,proved,proven,proves,proving,reaffirming,relied,relies,rely,relying,scaffolding,sentenced,sentencing,shelf,shore,shores,shoring,show,showed,showing,shown,shows,sponsorship,substantiated,sustain,sustained,sustaining,sustains,sustenance,swan,swans,swear,swearing,swears,swore,sworn,telling,tells,told,upheld,uphold,upholding,upholds,validates,validating,verify,warranted
SYN195	afford,afforded,affords,arm,armed,arming,articulate,articulated,boarded,border,bordering,borders,bottoming,capitalise,capitalize,capitalized,capitalizes,capitalizing,caption,captions,cater,catered,catering,caters,cede,cliff,cliffs,cloying,coal,coals,commit,commited,commits,committed,committing,computerized,consume,consumed,consumes,consuming,contribute,contributed,contributes,costumed,costuming,curtain,curtains,dangle,dangles,date,dated,dates,dating,dedicate,dedicated,dedicates,degenerated,degenerating,deliver,delivered,delivering,delivers,depleted,devote,devoted,devotes,devoting,dine,dines,donate,donated,drop,dropped,dropping,drops,dumped,economized,edge,edged,edges,edging,entrusted,entrusting,exfoliating,expended,expending,extend,extending,extends,fed,feed,feeding,feeds,filled,flood,flooding,fodder,fuel,fueled,fueling,fuelled,fuels,fulfill,fulfilled,fulfilling,fund,funding,funds,furnishing,gate,gates,generate,generated,generates,generating,glass,glasses,glasss,glaze,glazed,glut,gratifying,hat,hats,headline,headlined,headlines,headlining,horsing,joint,joints,keyed,keyes,leave,leaves,leaving,left,leverage,loaned,logistics,nourishing,nurturing,offer,offered,offering,offers,open,opened,opener,opens,pander,pandering,panders,partnered,patched,patching,pimp,pimping,pimps,plummet,plummeting,ply,plying,pour,poured,pouring,pours,powered,precipice,precipices,procured,procures,procuring,proffered,provide,provided,providing,provision,pump,pumped,pumping,pumps,rail,railed,railing,railroad,railroads,rails,raindrops,ramp,regaled,regales,reissued,relents,relinquish,render,rendered,rendering,renders,reopens,resubmit,returned,returning,sagged,sagging,sags,satisfied,satisfies,satisfy,save,scant,serve,served,serves,serving,sheltered,showered,showering,skimp,skimped,skimps,sojourn,spared,spares,sparing,spending,spends,spent,squander,squandered,squandering,squanders,staff,stint,stints,submit,submits,submitted,subtitle,subtitled,subtitles,subtitling,succumb,summer,sunday,supplied,supplies,supply,supplying,surfeit,surrender,surrendered,surrendering,surrenders,tapped,tapping,theme,themed,themes,tool,tooling,tools,topped,topping,tube,tubes,tubing,uncorking,uncorks,uniform,uniforms,unprotected,upholstered,vacationing,wanton,ware,wares,waste,wasting,watered,watering,waters,whisker,winter,yield,yielded,yielding,yields
SYN196	affordable,cheap,cheaper,cheapest,inexpensive
SYN197	aficionado,aficionados,bacchanal,beloved,beloveds,boyfriend,boyfriends,buff,buffs,darling,devotee,devotees,fan,fans,groupie,groupies,lover,lovers,paramour,petter,romeo,romeos,swain,sweetie
SYN198	afloat,aimless,aimlessly,awash,directionless,floating,flooded,full,fuller,fullest,inundated,overflowing,undirected,vagrant
SYN199	afoot,contemporary,current,incumbent,itinerant,kinetic,ongoing,prevalent,rife,squirming,touring,underway,writhing
SYN200	aforementioned,identical
SYN201	afoul,befouled,distasteful,enmeshed,filthy,foul,fouled,fouls,lugging,polluted,pollutes,skanky,smelly,smutty,tangled,unfair,unjust,yucky
SYN202	afraid,aghast,bullied,numb
SYN203	africa,africas
SYN204	afro,bang,bangs,haircut,haircuts,hairdos,hairstyles,marcel,ponytail,ponytails,roach,roaches
SYN205	aft
SYN206	afterglow,amenities,aurora,greenhouse,niceness,sunsets
SYN207	afterlife,alacrity,autobiography,biological,endurance,enthusiasm,exuberance,futures,ghetto,ghettos,immortality,life,lifes,lifespan,lifetime,lifetimes,liveliness,pep,survival,tomorrow,wildlife
SYN208	aftermath,aftermaths,branch,branches,comeuppance,consequence,consequences,decision,decisions,denouement,dent,deserts,effect,effected,effects,event,events,fruit,fruits,grandchild,impact,impacts,influence,influences,issue,issued,issues,issuing,offset,outcome,outcomes,payoff,payoffs,repercussions,result,resultant,resulted,resulting,results,separation,separations,sequel,sequels,termination,wages,wallop
SYN209	afternoon,afternoons,anniversary,bye,compliments,day,daylight,daylights,days,daytime,eve,evening,evenings,evens,eves,farewell,goodbye,hail,hails,halloween,halloweens,holiday,holidays,howdy,hullo,morning,morrow,payday,reception,receptions,response,responses,salute,salutes,todays,welcomes
SYN210	aftertaste
SYN211	afterthought,annex,attachment,extension,extensions,rethink,rethinking,rethinks,rethought,setback,turnabout,turnaround,turnarounds
SYN212	afterward,subsequently
SYN213	agamemnon
SYN214	agee
SYN215	agencies,agency,animation,animations,authorities,authority,behavior,behaviors,behaviour,brio,brokerage,bureau,bureaus,business,businesses,carrier,ceremonies,ceremony,chains,committee,concern,concerns,council,councils,distillation,employment,eruption,feedback,firm,firms,franchise,franchises,house,houses,hum,hums,manufacturer,occupations,oomph,organ,organs,oscillation,overdrive,partnership,partnerships,pizzazz,preparation,processor,processors,road,roads,salvation,selection,solidifying,state,stated,states,stating,synergism,synergy,teeth,tooth,virus,viruses
SYN216	agenda,agendas,bill,budget,budgets,canon,catalog,catalogs,catalogue,charted,constellations,engineers,episode,episodes,fare,fares,guideline,guidelines,hacked,hacking,index,installment,installments,instalment,interface,key,keys,layout,layouts,listings,masterminded,masterminding,menu,news,orchestrate,orchestrating,outline,outlines,plotting,program,programme,programmed,programmes,programming,programs,project,projection,projections,projects,queue,regime,regimen,regimes,roster,schedule,scheduled,schedules,scheduling,schema,scheme,schemes,serials,series,slotted,supervisor,supervisors,ticket,tickets,translator,translators,utility
SYN217	aggravation,aggression,bummer,discomfort,displeasure,exasperation,frustration,frustrations,harassment,headache,headaches,huff,huffs,impatience,irritation,provocation,provocations,restlessness,taunt,taunting,taunts,temper,tempers
SYN218	aggressive,assertive,belligerent,combative,competitive,invasive,militant,predatory,pugnacious,rapacious,rough,roughest,scrappy,unfriendly,voracious
SYN219	aggrieved,compassionate,grieve,grieving,improper,inopportune,mourn,mourned,pitied,pitying,unsuitable,untimely,wrongs
SYN220	agility,brightness,elation,euphoria,highlight,highlighting,insouciance,lightheartedness,lightness
SYN221	agitated,animate,bubbling,churning,crusade,crusades,displaced,electrify,electrifying,enliven,enlivening,enlivens,forced,frantic,frenzied,frothing,inspire,invigorate,invigorated,invigorating,jolted,masturbates,poked,poking,promoted,promotes,promoting,pushes,quickening,scramble,scrambled,scrambles,scrambling,sex,sexed,sexes,thrill,thrilled,thrilling,thrills,titillate,tossed,tossing,transfers,transport,transports,trouble,troubles,troubling,vibrate,vibrates,vibrating
SYN222	ago,ancient,bygone,erstwhile,foregone,historical,late,medieval,olden,prehistoric,previous,recent,ultimo
SYN223	agreeable,consensual,consistent,unanimous
SYN224	ahab
SYN225	ahead,forward,forwards,leading,onward,onwards
SYN226	aim,aimed,aiming,aims,aspire,aspired,aspires,bearings,blueprint,blueprints,design,designated,designed,designing,designs,destination,destined,direct,direction,directions,end,ended,ending,ends,engineer,engineered,goal,goals,grail,guidance,guiding,idea,ideas,intend,intended,intending,intends,intent,intention,intentions,intents,level,leveling,levels,meaner,meanest,meaning,means,meant,mind,minds,object,objective,objectives,objects,plan,planned,planning,plans,point,pointed,pointing,points,propose,proposed,proposes,proposing,purported,purports,purpose,purposes,signified,signify,signifying,slate,slated,slates,steer,steers,terminus,thinking,thought,ways,wills
SYN227	airborne,racy,versatile
SYN228	aircraft,bogies,cobbling,craft,crafted,craftiness,crafting,crafts,craftsmanship,lumbering,pyrotechnic,pyrotechnical,pyrotechnics,spacecraft,vessel,vessels
SYN229	airhead,airheads,bonehead,boob,boobies,boobs,booby,childlike,cretin,cretins,dimwit,dimwits,doofus,dullard,dumbass,dunces,elementary,foothold,hammerhead,idiot,idiots,imbecile,imbeciles,knucklehead,knuckleheads,lame,lunkhead,lunkheads,moron,morons,nebbish,nincompoop,nincompoops,ninny,nitwits,poop,sap,saps,schnook,sheep,shitheads,simple,simpleton,simpletons,stupids,twit,uncomplicated
SYN230	airline,biz,boundaries,boundary,coax,coaxes,cribbed,cribbing,dateline,hairline,hose,hoses,lens,liaison,liaisons,lineup,perimeter,pipeline,pipelines,policies,policy,railway,shroud,sideline,sidelines,skyline,skylines,skyways,spiel,tights,vocation,watershed
SYN231	airliner,airplane,airplanes,amphibian,amphibians,bomber,bombers,fighter,fighters,jet,jets,plane,planes,planing
SYN232	airlock,bedroom,bedrooms,chamber,chambers,cylinders,furnace,ventricle
SYN233	airport,battlefield,battlefields,paddy
SYN234	airwaves,album,albums,atmosphere,atmospheres,aura,bared,breath,breaths,broadcast,broadcasted,broadcasting,broadcasts,cinema,cinemas,ether,fanfare,interrogate,interrogated,interrogates,interrogating,media,medium,mediums,melodies,melody,mystique,publish,publishes,satellite,satellites,spiritualist,telecast,telecommunications,televised,transmit,transmits,transmitting,vehicle,vehicles,venting
SYN235	aisle,aisles,auditorium,cadence,canal,canals,choir,cleavage,conduit,corridor,corridors,courtyards,danger,dangers,duct,ducts,esophagus,fireside,hangout,headings,hideaway,intro,intros,midriff,midsection,nook,nooks,passage,passages,playground,province,quadrangle,region,segue,segues,territories,territory,text,texts,transition,transitions
SYN236	aix,amazonas,anser,chen,chens,circus,falco,otis,pastor,penelope,prunella
SYN237	ajax
SYN238	akin,analogous,clan,kindred,related
SYN239	al,alabama,als,alum,aluminium,amalgam,ca,calcium,cd,cds,chromium,copper,cos,crs,cs,er,ers,es,fe,fm,gd,hf,ho,hos,ins,la,las,leaden,li,lis,lithium,lu,mercury,mo,mos,na,pa,palladium,pas,pbs,pd,pm,pr,quicksilver,ra,sodium,ta,titanium,tm
SYN240	ala,alas,backstage,calculation,degeneration,digit,digits,flank,flanks,hair,hairs,offshoot,offshoots,offstage,overworked,overworking,phenomenal,photography,process,processed,processes,processing,rework,reworked,reworking,reworks,ridge,rigmarole,spine,sue,sued,sues,suing,tentacle,tentacles,wing,wings
SYN241	aladdin
SYN242	alamo
SYN243	alar,chemicals,explosive,explosives,fraction,fractions,pesticides,product,products,softener,winged
SYN244	alarm,alarmed,alarming,alert,alerted,appaling,appalled,appalling,appalls,awe,awed,bluff,chill,chills,consternation,curfew,dismay,dismayed,dismaying,dismays,dread,dreads,drumbeat,fear,feared,fearing,fears,fright,frighten,frightening,frightens,frights,frisson,hooters,horrifies,horrifying,hysteria,indicator,input,inputs,intimidate,intimidated,intimidates,intimidating,intimidation,output,recording,scare,scared,scares,scaring,shiver,shivers,shock,shocked,shocking,shocks,shudder,signal,signaled,signaling,signals,spooked,spooking,symbol,symbols,terrifies,terrify,terrifying,terror,terrorise,terrorize,terrorized,terrorizes,terrorizing,terrors,timidity,tingle,tingles,torpedoes,warn,warned,warning,warns,whistle,whistles,whistling
SYN245	alaska
SYN246	albania,albanian
SYN247	albany
SYN248	albert
SYN249	alberta
SYN250	albino,albinos,anomaly,behemoth,eccentric,eccentrics,flake,flakes,giant,giants,goliath,misfit,misfits,monster,monsters,oddball,oddballs,transexual,transsexual
SYN251	alchemy,astrology,chemistry
SYN252	alcoholic,alcoholics,douse,doused,dousing,drunk,drunkard,drunks,inebriated,intoxicating,lush,potent,soak,soaked,soaking,soaks,soused,strong,stronger,strongest,wet,wets,wino
SYN253	alcoholism,drunkenness,egomania,frenzy,inebriation,mania,necrophilia,possession,possessions
SYN254	alcott,alcotts
SYN255	alexander,alexanders
SYN256	alexandria
SYN257	alfred,alfreds
SYN258	algae
SYN259	alger
SYN260	algeria
SYN261	ali,alis
SYN262	alias,aliases,announce,appellation,baptizes,christened,christening,dub,dubbed,dubbing,dubs,enumerates,explore,explored,explores,exploring,identified,identifies,identify,identifying,list,listed,listing,lists,nickname,nicknamed,nicknames,pseudonym,pseudonyms,surname,termed,title,titled,titles
SYN263	alibi,alibis,apologies,condone,defences,defense,defenses,denial,displacement,entrapment,excuse,excuses,explain,explained,explaining,explains,fortress,fortresses,isolation,mining,rationalization,rebuttal,regression,repression,stronghold,vindication
SYN264	alike,comparable,ilk,interchangeable,likewise,prefer,prefered,preferring,prefers,replaceable,similar,synonymous
SYN265	alive,animated,awake,aware,bouncy,conscious,enlivened,existent,existing,live,lived,livelier,lively,lives,living,peppy,resilient,spirited,springy,viable,vital
SYN266	allah
SYN267	allegiance,allegiances,collaboration,commitment,commitments,concurrence,cooperation,dedication,devotion,enlistment,fealty,loyalties,loyalty,oath,patriotism,pledge,reconciliation,selflessness,teamwork
SYN268	allegorical,allegorically,emblematic
SYN269	allen,allens,gracie
SYN270	allergic,allergies,allergy,allied,alpine,alternately,alternatively,amazingly,ambiguously,ambitiously,american,amusingly,appropriately,responsive,susceptible
SYN271	alley,alleys,alleyways,avenue,avenues,boulevard,lane,lanes,street,streets
SYN272	alligator,alligators,calf,cayman,chap,chapped,chaps,crack,cracked,cracking,cracks,crannies,craze,crazed,crevasse,crocodile,crocodiles,fissure,gator,gators,leather,leathers,morocco,roan,sally,sallys,topnotch,tornado,tornadoes,wisecrack,wisecracks
SYN273	allocate,allocated,allotted,allotting,anthropomorphized,appendages,awarded,awarding,basis,classifies,classify,classifying,credited,cutout,cutouts,delegates,demoted,destiny,devolve,earmarks,foible,foibles,helpings,internalize,internalized,internalizing,luck,mandated,misfortune,misfortunes,particulars,providence,regiment,regiments,relegated,relegating,task,tasked,thigh,thighs,upstages
SYN274	allowances,allowed,allowing,disjointed,dole,grant,grants,hub,item,items,leeway,lets,letting,licence,license,margin,margins,part,parted,parting,parts,percentage,percentages,permission,permit,permits,permitted,piece,pieces,portion,portions,section,segment,segments,share,shared,shares,sharing,slice,slices,split,splits,stake,stakes,tolerance,tolerate,tolerated,tolerates,tolerating,upstairs,waist,wreckage
SYN275	alluring,beguiling,behest,bid,bidding,entice,enticed,entices,enticing,insidious,invitation,lured,preempt,seduce,seduced,seduces,seducing,seductive,tempt,tempted,tempting,tempts,underbids
SYN276	allusion,allusions,commented,commenting,consultation,criteria,criterion,encyclopedia,encyclopedias,handbook,quotation,quotations,referenced,references,referencing,remark,remarked,remarking,remarks,retrospection,touchstone
SYN277	almanac,annual,yearbook
SYN278	aloft
SYN279	alongside,onboard
SYN280	aloofness,altitude,apathy,closeness,distance,distanced,distances,distancing,indifference,interval,introversion,mileage,numbness
SYN281	aloud,forte,garish,loud,louder,loudest,loudly,tacky,tawdry,trashiest,trashy
SYN282	alpha,began,begin,begining,beginning,begins,begun,beta,beth,beths,chi,commence,commencement,commences,commencing,consequential,consonants,crucial,delta,deltas,eminent,eventful,exploratory,fundamental,graver,grievous,historic,inaugurate,initials,iota,izzard,kickoff,letter,lettering,letters,main,missive,nu,nun,nuns,omega,omegas,oncoming,originated,outstanding,phi,pi,pis,primal,principal,sin,sins,springboard,start,started,starting,startle,starts,startup,strategic,weighty,zed
SYN283	alps,arab,arabs,ben,bens,climb,climbs,morgan,mountains,pave,paves,prancer,volcanic,volcano,volcanoes,volcanos,wax,waxes
SYN284	alright,confirm,confirmed,confirms,copasetic,endorsing,exquisitely,fine,finer,finest,sanctioned,satisfactory,ticketed,visa,visas
SYN285	altar,arcade,balcony,boarding,bowl,bridge,buildings,calendar,clause,column,costa,desk,door,doors,edifice,erection,establishment,feudal,fountain,hangar,hill,hills,impediment,landings,lookout,memorial,mesa,monument,monumental,monuments,mound,observatory,partition,partitions,passageways,patriarchy,platform,plexus,porch,porches,postponed,receptors,segregation,stadium,structured,superstructures,table,tables
SYN286	altercation,altercations,bicker,bickering,bickers,brawl,brawls,fuss,soliloquy,spat,spats,squabble,squabbles,tiff
SYN287	alternate,alternated,alternates,alternating,alternative,alters,americanised,americanized,americanizing,antiquated,assimilate,assimilating,awaken,awakened,awakening,awakens,backup,barb,barbed,barbs,barter,blunt,blur,blurred,blurs,boil,boiled,boiling,boils,brighten,brightened,brightening,brightens,bring,bringing,brings,broadens,brought,brutalized,coagulate,commutes,complicate,complicated,complicates,complicating,con,concentrating,conned,conning,cons,conversion,conversions,correct,corrected,correcting,corrects,crackled,cyclic,darken,deadening,deformed,descend,desensitized,destabilize,destabilizing,dissolve,dissolved,dissolves,disturbed,disturbing,dries,drifted,drying,edit,edited,editing,edits,evaporated,evaporates,evaporating,exchange,exchanged,exchanges,flip,flipped,flipping,flips,freshen,glorified,glorifies,glorify,glorifying,hop,hurry,improve,improves,improving,interchange,jump,jumped,jumping,jumps,leap,leaping,leaps,learn,learned,learning,learns,learnt,metamorphoses,moderate,modified,modify,motion,motions,movement,movements,neutralize,objectified,objectifying,obscure,obscured,obscures,obscuring,overturned,ransom,reclaim,reclaiming,reconstructed,rectified,rectify,redeem,redeemed,redeeming,redeems,refining,relax,relaxed,relaxes,relaxing,relief,replacement,replacements,reversal,reversals,reverse,reversed,reverses,reversing,revert,reverted,reverts,rewarded,righting,rights,romanticized,romanticizes,romanticizing,rotary,rotate,rotates,rotating,roused,rousing,sanitized,sauce,sentimentalized,shallows,sharpening,shoals,soften,softened,softening,softens,stabilize,strengthen,strengthens,sublimated,subs,substitute,substituting,substitution,substitutions,successor,successors,surrogate,suspend,suspended,suspending,suspends,swap,swapping,swerve,switch,switched,switches,switching,swopes,tack,tacked,tacks,tame,taming,thickens,tosses,toyed,trade,trades,trading,transfer,transferred,transferring,turn,turned,turning,turns,understudy,undid,undo,undoes,undoing,undone,unified,unifying,unite,unites,varied,varies,vary,varying,veering,warmed,warms,widening,widens,worsened
SYN288	althea,altheas
SYN289	altogether,nude,nudity,raw,totally,unharmed,unit,units,unscathed,wholly
SYN290	altruist,contributors,donor,donors,givers,philanthropist,presenter,subscribers
SYN291	altruistic,selfless
SYN292	alumni,alumnus,alums,doctor,doctors,grad,graduate,graduated,graduates,graduating,historian,historians,master,masters,musicologist,philosopher,philosophers,reader,readers,scholar,scholars,student,students,theologians
SYN293	alzheimers
SYN294	amalgamation,amalgamations,incorporation,integration,mergers,reunion,reunions,umbrella,umbrellas
SYN295	amarillo
SYN296	amateurish,amateurs,hobbyist,nonprofessional,unprofessional,unskilled
SYN297	amateurism,conviction,convictions,sentence
SYN298	amaze,amazed,amazes,amazing,annoy,astonished,astonishing,astound,astounded,astounding,baffle,baffled,baffles,baffling,beat,beaten,beating,beats,befuddled,bemused,bemusing,bewilder,bewildered,bewildering,confound,confounding,confounds,confuse,confused,confuses,confusing,dazzle,dazzled,dazzles,discombobulated,disoriented,disorienting,dumbfounded,earn,elude,eluded,eludes,eluding,escape,escaped,escapes,escaping,flail,flailing,flapping,floored,flummoxing,fox,foxs,hammered,hammering,hurl,hurls,landed,mystified,mystifying,nonplused,nonplussed,obtain,obtained,obtaining,obtains,perplexed,perplexes,perplexing,puzzle,puzzled,puzzling,receive,receives,receiving,regain,regains,riddle,riddled,riddles,shies,stick,sticking,sticks,stump,stumped,stupefied,stupefying,surprise,surprised,surprises,surprising,thrash,toss
SYN299	amazon,baggage,broads,cinderella,cinderellas,coquette,dame,debutante,delilah,delilahs,divorcee,dominatrix,donna,donnas,exs,eyeful,geisha,gentlewoman,girl,girlfriend,girlfriends,girls,heroine,heroines,knockout,ladies,lady,looker,lulu,macaw,madam,matriarch,matron,matrons,missy,mistress,nannies,nanny,nymphet,phoenix,prostitute,prostitutes,siren,sirens,stunner,sweetheart,sweethearts,tart,tarts,temptress,whore,whores,widow,widows,wife,wifes,wives,woman,womans,women
SYN300	ambassador,ambassadors,apology,congressman,congresswoman,consul,delegate,diplomat,diplomats,emissaries,emissary,flack,interpreter,middlemen,minister,ministers,mouthpieces,passive,phonation,primo,rep,representative,representatives,spokesman,spokesperson,spokeswoman,symbolist,voice,voiced,voices,voicing
SYN301	amber,ambers,anime,animes,au,canary,creamy,cyan,gold,golden,golds,hazel,magenta,mousy,oliver,purplish,reddish,salmon,stoner,straw,straws,tangerine,violet,yellow,yellowish,yellows
SYN302	ambiguous,double,doubled,doubles,dual,enigmatic,evasive,indeterminate,twofold,unstructured
SYN303	ambitionless,unambitious
SYN304	ambitions,aspiration,aspirations,begrudging,bloodlust,cared,chauffeur,chauffeuring,consumerism,crave,craves,dearth,deficiencies,deficiency,dream,dreamed,dreaming,dreams,dreamt,driveway,envied,envying,gasp,hankering,hope,hoped,hopes,hoping,hunger,impetus,impulse,impulses,itching,joyride,lack,lacks,likes,liking,longed,longing,longings,longs,lusted,lusting,materialism,nationalism,seeking,temptation,temptations,thirst,thirsting,toenail,toenails,wanted,wanting,whim,wished,wishes,wishing,yearn,yearning,yearnings,yearns
SYN305	ambitious,arduous,aspiring,catchy,compulsive,determined,difficult,envious,hard,harder,hardest,herculean,nastier,nastiest,nasty,perfectionist,pushy,rocky,rugged,sticky,thorny,touchy,tougher,toughest,trickier,trickiest,tricky,troublesome,unenviable,wishful,workaholic,workaholics
SYN306	ambivalent,doubtful,dubious,groping,hesitant,iffy,uncertain,unsure
SYN307	ambles,ambling,boardwalk,catwalks,doddering,gait,gimp,hike,hobbling,keel,keels,mall,malls,march,marched,marches,marching,mosey,moseys,parade,paraded,parading,pavement,plod,plodding,plods,prom,promenade,prowls,pussyfoot,ramble,rambles,sauntering,saunters,shuffle,shuffled,sidewalk,sidewalks,sleepwalk,sleepwalking,sleepwalks,slink,slinking,slinks,slouched,slunk,spacewalk,staggering,staggers,stalked,stomp,stomped,stomping,stomps,stroll,strolling,strolls,strutting,tiptoe,tiptoeing,trampled,trotted,trotting,trudge,trudging,waddle,waddling,wade,waded,wades,wading,walk,walked,walking,walks,walkway
SYN308	ambroses
SYN309	ambulance,auto,automobile,automobiles,autos,bagger,bus,buses,busses,cab,cabs,car,cars,compact,compacts,computers,cruiser,cruisers,cyborg,digger,diggers,electric,hack,hacks,heap,heaps,jeep,lever,limo,limousine,limousines,machine,machinery,machines,minivan,phonograph,racer,racers,roadster,taxi,wagon,workhorse
SYN310	ambush,ambushes,campaign,campaigns,drive,driven,drives,driving,drove,falcon,ferret,ferreted,ferrets,fowl,hawk,hawkes,hawking,hawks,hunt,hunted,hunting,hunts,ladder,ladders,lurk,lurking,lurks,outrun,outrunning,outruns,rabbit,rabbits,ran,rerun,reruns,run,running,runnings,runs,scrounges,seal,sealed,seals,snare,snipe,snipes,sniping,sprint,sprinting,sprints,trap,trapped,trapping,traps,turtle,turtles,waylaid,whale,whales
SYN311	amen,amon
SYN312	amendment,amendments,announcement,announcements,assurance,commentaries,commentary,compensation,description,descriptions,falsehood,formula,formulas,proclamations,replies,reply,representation,representations,restatement,retribution,solutions,solvent,truth,truths,understatement
SYN313	america,americas,armies,army,armys,bushel,cia,cias,cooperative,fifths,gal,gallons,gals,gills,pint,po,pos,quart,senate,ss,usa,usaf,vi,vis
SYN314	americana,anachronisms,article,articles,artifact,artifacts,cloth,cloths,commodities,commodity,construction,decker,decoration,duplicate,duplicates,extra,extras,fabric,facility,facilitys,fixture,goods,inset,installation,installations,lemon,lemons,material,materials,ornament,padding,plaything,playthings,restoration,sphere,spheres,squeaker,stinker,stinkers,structure,structures,surfaces,toy,toys,weight,weights
SYN315	americans,arizonians,asian,asians,aussie,aussies,australian,australians,bostonians,denizen,denizens,dweller,dwellers,earthling,earthlings,ebonics,european,hoosiers,inhabitant,inhabitants,occupants,resident,residents,tarheels,villagers,virginian,westerner,westerners,yank,yankee,yankees,yanks
SYN316	amicable,friendliest,friendly
SYN317	amish
SYN318	amiss,askew,awry,haywire,lopsided,malfunctioning,wrong
SYN319	ammo,ammunition,ammunitions,arms,bastion,bomb,bombs,canister,cartridges,hardware,palisades,tracer,weaponry
SYN320	amnesiac,asinine,fatuous,forgetful,inane,inanely,mindless,oblivious,paraplegic
SYN321	amoeba
SYN322	amok,amply,amuck,anatomically,angrily,animatedly,berserk,certifiable,insane,maniacal,moonstruck,possessed,psychopathic,schizophrenic,screwy
SYN323	amor,cupid
SYN324	amoral,impersonal,neutral
SYN325	amos
SYN326	amputated,assumed,ate,bail,bailed,bailing,bails,bone,bones,boning,boozed,boozing,borrow,borrowed,borrows,brush,brushed,brushes,brushing,burr,bused,cancel,canceled,cancelled,cancels,cannibalize,cheque,chooses,choosing,chose,clean,cleaned,cleaning,cleans,cleared,clearing,clears,condense,condensed,confiscate,confiscates,convey,cream,creams,crumb,crumbs,culls,defanged,defuse,defusing,delete,deleted,deleting,delve,delved,delves,delving,deprive,deprived,detract,detracted,detracting,detracts,disemboweling,disengaged,disengaging,dismantling,divest,divesting,draw,drawing,drawn,draws,dredge,dredges,dredging,drew,drug,drugs,eat,eaten,eating,eats,elected,electing,empty,emptying,estranged,estranging,eviscerated,exact,exacted,exacting,exacts,excavating,excerpt,excerpted,excerpts,extract,extracted,extracting,extracts,filmed,fleshed,fleshing,flick,flicks,freed,freeing,frees,gut,guts,handing,harvest,harvesting,harvests,headed,heading,hollow,hull,husk,ingest,ingested,ingesting,laded,laden,ladens,lift,lifted,lifting,lifts,mislead,misled,muck,mucked,necessitates,needing,ousted,overdrawn,partake,partakes,partaking,pausing,payback,paybacks,pick,picked,picking,picks,pit,pits,pitted,pitting,plunder,plundering,pull,pulled,pulling,pulls,recedes,remove,removed,removes,removing,replete,rescue,rescued,rescues,rescuing,reshoot,reshooting,reshoots,retake,retire,retreated,retreating,sacked,sampled,sate,scale,scales,scaling,scalp,scavenge,scoop,scooped,scooping,scum,secluded,secluding,selected,selecting,selects,sequestered,severed,shed,sheds,shell,shelled,shelling,shells,shucking,shucks,skim,skims,smoked,spoons,stem,stemmed,stemming,stems,stone,stoned,stones,string,strings,strip,stripped,stripping,strips,takes,taking,tip,tipped,tipping,unbridled,undress,undresses,undressing,unhinged,unlock,unlocked,unlocks,unveil,unveiled,unveiling,unveils,usher,ushered,usurp,usurped,voted,wash,washed,washing,weed,weeds,welcomed,withdrawing,withdrawn,withdrew
SYN327	amputation,castration,constipation,deterioration,detriment,disability,handicap,handicapped,onset,operation,operations,operative,surgery,surgical,taxes,taxis,tracheotomy,transplant
SYN328	amsterdam
SYN329	amulet,fetish,fetishes,glamour,hex,hoodoo,incantation,incantations,jinx,mesmerize,voodoo
SYN330	amundsen
SYN331	amuse,amused,amusing,banzai,cheer,cheered,cheerfulness,cheering,cheerleading,cheers,detour,deviate,deviates,deviating,digress,digresses,divert,diverted,diverting,diverts,entertained,entertaining,heartening,hooray,hosted,hosting,hurrah,lightening,rejoiced,rejoicing,sidetracked,sunniness,triumphed,triumphing
SYN332	amusement,amusements,antics,bathing,caper,celebration,celebrations,dance,dances,dancing,delight,delighted,delighting,delights,distraction,distractions,diversions,endear,endearing,enjoyment,enraptured,entertainment,entertainments,enthrall,enthralled,enthralling,escapade,escapades,escapism,extravaganza,extravaganzas,festivities,frolic,fun,gambling,gambols,gaming,joke,jokes,lark,merriment,nightlife,playfulness,pleases,pursuit,pursuits,ravished,ravishing,recreation,recreational,recreations,reveling,revelled
SYN333	amyl,amyls,anarchist,anarchists,edition,editions,embedded,extremist,extremists,group,grouped,groupings,groups,humankind,humankinds,mankind,mankinds,marxist,nihilist,nihilists,nitrite,people,peoples,racial,radical,radicals,regroup,revolutionaries,subversive,team,teamed,teaming,teams,terrorist,terrorists,ultra,vinyl,wobbly
SYN334	anaconda,anacondas
SYN335	analogue,likeness,linear,parallel,parallelism,parallels,similarities,similarity,tropic,tropical,tropics
SYN336	analogy,buddhism,buddhist,christian,christianity,church,churches,churchs,confrontations,cult,cults,extrapolation,faith,faiths,hindi,hindu,implication,implications,judaism,mysticism,presumption,religion,religions,sect,sects,wicca,wiccan
SYN337	analyse,analyses,analyze,analyzed,analyzes,analyzing,anatomizes,canvas,cauterize,cauterizes,cherish,considered,considers,detox,dispense,dispensed,dispenses,dispensing,dissect,dissected,dissects,doctored,examine,examined,examines,examining,inspect,investigate,investigated,investigates,leeched,leeches,massage,massages,massaging,nursing,perused,poll,psychoanalyze,quizzing,review,reviewed,reviewing,reviews,sail,sails,screen,screened,screening,screens,scrutinize,scrutinized,scrutinizing,searched,searching,sift,surveying,tarp,trace,traced,traces,tracing,treat,treated,treating,treats,view,viewed,viewing,views,wronged
SYN338	analysis,analytic,anticipation,breakdown,coarseness,conjectures,criticisms,critique,critiques,deduction,deductions,elimination,eloquence,examination,examinations,fashion,fashions,genre,genres,inferences,inquiries,investigating,investigation,investigations,jargon,pathos,poetry,prediction,predictions,prose,reductionism,research,researches,rhetoric,scrutiny,style,styled,styles,styling,synthesis,terseness,testings,vein,veins,wiretaps
SYN339	analyst,analysts,arbiters,archer,archers,atrophied,atrophy,bowman,bowmans,commentator,commentators,computer,expertly,experts,headhunter,healer,healers,horticulturist,observer,proficient,psychiatrist,psychiatrists,psychoanalyst,psychoanalysts,shrink,shrinking,shrinks,shrunk,shrunken,skilful,skillful,skillfully,specialist,talent,talents,therapist,therapists
SYN340	analytical
SYN341	anarchic,errant,irrepressible,masterless,rampant,runaway,torrential,uncontrollable,uncontrolled,undisciplined,unlawful
SYN342	anarchy,clutter,complaint,complaints,confusion,deranged,disarray,discord,disorder,disorders,disorganization,disquieting,distract,distracting,distracts,disturbance,ills,instability,jumble,jumbles,messed,messiness,messing,nihilism,perturbed,rioting,shambles,strangulation
SYN343	anatomy,bluntness,bodies,body,bodys,build,building,builds,built,carve,carves,circle,dimension,dissection,dullness,flair,flatten,flattened,flesh,fleshes,form,formed,forms,frame,framed,frames,framing,kaleidoscope,layered,mold,molded,molding,molds,mould,person,persons,physique,preforming,sculpted,sculpting,shape,shaped,shapes,shaping,skeleton,skeletons,squares,terrace,tower,towers,triangle,triangles,walker
SYN344	ancestor,ancestors,ancestral,coition,coitus,comparison,comparisons,copulation,cousin,cousins,descendant,descendent,dominant,dominating,father,fathers,filial,forefathers,kin,kinship,offspring,ownership,partner,partners,progenitor,progeny,proportionate,relation,relations,relationship,relationships,relative,relatives,root,rooted,roots,sibling,siblings,sire,solution,spouse,spouses,unconnectedness
SYN345	ancestry,blood,bloodline,bloodlines,bloods,breed,breeds,descent,extraction,families,family,familys,folk,folks,heritage,kinfolk,lifeline,line,lineage,lines,lining,linkage,origin,origins,pedigree,sept,side,sides,stock,stocks
SYN346	anchor,anchoring,anchorman,anchors,backbone,bandaged,bandages,belays,belt,belted,belting,belts,bind,binding,binds,brad,buckle,buckles,button,buttons,cable,cables,cement,cemented,cementing,cements,chain,chained,clamp,clamps,clinches,cramp,cramped,cranked,cranking,earth,earths,entrenched,fastened,garters,girth,ground,grounds,hang,hanged,hanging,hangs,hook,hooked,hooking,hooks,hung,keystone,latch,latched,latches,linchpin,lynchpin,maintenance,patronize,patronized,patronizing,picket,pickets,pier,piers,riveted,riveting,secure,secures,securing,sewed,sewing,sewn,sews,spiked,sponsor,sponsors,staked,staking,staple,stapled,staples,stitch,stitched,stitches,stitching,strap,strapped,strapping,straps,support,supported,supports,upkeep,wedged
SYN347	andersen,andersens
SYN348	anderson,andersons
SYN349	andrews
SYN350	android,androids,automaton,automatons,humanoid,humanoids,robot,robots
SYN351	andromeda,broom,brooms,bush,bushes,bushs,camelia,cotton,cottons,cranberries,dahl,daphne,dubya,elder,elders,gardenias,heath,hemp,huckleberry,jasmine,jasmines,lavender,outback,pixie,roses,shrubs,tea,ti,tis,tumbleweeds,wahoo
SYN352	anecdote,anecdotes,billed,billing,biographical,biographies,biography,bulletins,chit,chronicle,chronicles,comment,comments,definition,definitions,describe,describes,describing,etymology,exclusive,explanation,explanations,interpretation,justification,narration,narrations,newsletter,recitals,report,reported,reporting,reports,reputation,stories,story,storys,yarn,yarns
SYN353	anew
SYN354	ang
SYN355	angelica,asparagus,basil,buckwheat,buttercup,canna,carrot,columbo,dill,flavoring,garlic,ginger,ginseng,herb,herbal,honesty,lettuce,mandrake,medic,mint,paprika,parsley,pepper,peppers,pimpernel,primrose,rosemary,rosemarys,saffron,sage,salt,salts,seasoning,spice,spices,strawberry,thyme,tobacco,tomato,tomatoes,vanilla,vegetables,viola
SYN356	anger,angered,angering,angers,annoyance,annoyances,arouse,aroused,arouses,arousing,avarice,bless,bruise,bruised,congratulate,congratulates,conjure,conjures,conjuring,damning,disconcerted,disconcerting,educes,elevate,elevated,elevates,elevating,elicit,elicited,eliciting,elicits,entertain,entertains,envies,envy,erected,evoke,evoked,evokes,evoking,exasperated,excite,excited,excites,exciting,experience,experienced,experiences,experiencing,fury,glow,gluttony,greed,hackles,heat,heated,hurt,hurting,hurts,ignite,ignited,ignites,igniting,infatuated,inflames,injure,injured,injures,interest,interested,interesting,interests,ira,iras,ire,joy,joys,lust,lusts,offence,offend,offended,offending,offends,offense,overcame,overcome,overcomes,overcoming,overpower,overpowered,overpowering,overpowers,overtake,overtaken,overtakes,overtaking,overwhelm,overwhelmed,overwhelming,overwhelms,prick,pricked,pricking,pricks,rage,rages,recapture,recaptured,regret,regretted,regretting,rejoice,rekindle,rekindling,reliving,repent,rue,saddened,saddening,saddens,shake,shaken,shakes,shaking,shame,shook,sloth,smolder,smoldering,spite,stimulate,stimulates,stimulating,stir,stirred,stirring,stirs,suffer,suffered,suffers,sympathise,sympathize,sympathized,sympathizes,upset,upsets,upsetting,wake,wakes,waking,whelmed,woke,woken,wound,wounded,wounding,wounds,wrath
SYN357	angrier,angry,black,blacker,blackest,blacks,enraged,furious,indignant,infuriated,irascible,irate,mad,maddened,outraged,sore,stormy,tempestuous,wild,wilder,wildest,wroth
SYN358	angst,anxieties,anxiety,edginess,insecurities,insecurity,nervousness,panic,qualms
SYN359	angular,asteroid,triangular
SYN360	angus,durham,gripe,gripes,hamburger,hamburgers
SYN361	ani,cuckoo,cuckoos,geese,goofball,jackass,roadrunner
SYN362	animal,animals,beast,beasts,brute,creatures,mutant
SYN363	animalities,animality,disposition,nature,natures,temperamental
SYN364	animatronics,robotics
SYN365	animosity,animus,antagonism,bitterness,enmity,gall,hostility,rancor,resentment,suspicion,suspicions,tension,tensions,violence
SYN366	ankles,dovetail,wrist,wrists
SYN367	anna,annas
SYN368	anne,annes
SYN369	annihilate,assassinate,assassinates,beheaded,beheadings,brained,butchered,crapped,deathblows,decapitate,decapitated,decapitates,decapitating,decapitation,decapitations,decimated,decimating,defeating,defecated,depletes,destroy,destroying,destroys,dismember,dismembered,dismembering,dispatch,dispatched,dispatching,drown,drowned,drowning,drowns,electrocuted,electrocuting,electrocution,eliminate,eliminated,eliminates,eliminating,eradicate,eradicated,erase,erased,erasing,excepting,excepts,exterminate,exterminated,exterminating,extinguished,extinguishing,exude,exudes,exuding,fried,frying,genocide,homicide,homicides,impaled,impales,kill,killed,killing,kills,lynch,lynched,lynching,lynchs,massacre,massacres,obliterate,obliterated,obliterates,obliterating,offed,overlaid,overlay,overlays,poison,poisoned,poisoning,poisons,preclude,precluded,saber,sacrifice,sacrifices,sacrificial,slain,slaughter,slaughtered,slaughtering,slaughters,slay,slaying,slays,smother,smothered,smothering,spend,suicide,suicides,urinate,urinates,urinating
SYN370	annihilation,demolition,desolation,destruction,destructions,devastation,disintegration,extermination,holocaust,obliteration,ravages,ruin,ruination,ruins,sabotage,sabotages,vandalism,wrack,wrecking
SYN371	announcer,author,authors,broadcaster,caller,confessor,correspondents,dj,informant,informants,negotiator,negotiators,newsman,popularizer,publicist,reporter,reporters,sender,sportscaster,sportscasters,transmitter,warner,warners,writer,writers,yeller
SYN372	annoyed,annoying,annoys,antagonizes,antagonizing,beset,bother,bothered,bothering,bothers,chafing,chevy,devil,devils,displeased,fret,fretting,grate,grates,grating,harassed,harasses,harassing,harried,harries,harry,harrys,hassle,hassled,hassles,irritate,irritated,irritates,miffed,molest,molesting,pissed,plagued,plaguing,provoke,provoked,provokes,provoking,rag,rile,riled,ruffle,stung,troubled
SYN373	annoyingly,anthropological,appalachian,appallingly,apprehensively,bothersome,corruptive,disagreeable,epidemic,irritating,irritatingly,pesky,pestering,septic,teasing,vexatious,vexing
SYN374	anonymity,limbo,oblivion,obscurities,obscurity
SYN375	anonymous,anonymously,faceless,foreigners,nameless,outsiders,strangers,unfamiliar,unidentified,unknown,unknowns,unnamed,unsung,unsuspected
SYN376	anorexics,depressive,diabetic,incurable,insomniac,insomniacs,lunatic,lunatics,madman,madmans,madmen,maniac,maniacs,martyr,martyrs,narcoleptic,neurotic,patient,patients,psycho,psychos,psychotic,psychotics
SYN377	ant,ants,bee,emmet,wasp,wasps
SYN378	antagonistic,antipathetic,averse,contrastive,hostile,incompatible,loath,negative
SYN379	antarctica
SYN380	anthem,aria,ballad,ballads,carol,carols,chant,choral,ditties,ditty,hymn,hymns,lament,laments,oldies,outspoken,paean,requiem,song,songs,vocal,vocals
SYN381	anthesis,blossoming,cohesion,culture,cultures,development,developments,evolution,growing,growth,increments,maturation,phenomena,phenomenon,proliferation,rooting,suppression,tumor,underdevelopment,unfolding
SYN382	anthology,asia,asias,assemblage,biology,categories,category,collage,compilation,congregation,congregations,data,datas,exhibition,expo,exposition,expositions,fauna,findings,galactic,galaxies,galaxy,garland,gatherings,intergalactic,menagerie,mythology,population,prosecution,repertoire,smithereens,smorgasbord,universe
SYN383	anthony,anthonys,antony
SYN384	anthrax,crud,disease,diseases,hydrophobia,incompetence,madness,rabid,rabies
SYN385	anthropologist,anthropologists,archeologist,sociologist
SYN386	anthropology,archaeological,archaeology,economics,politics,sociology
SYN387	antichrist
SYN388	anticipants,dreamer,dreamers,expectant,forecaster,hopeful,idealist,oracle,oracles,prophet,prophets,seer,soothsayer,utopian,visionaries,visionary
SYN389	anticipated,anticipates,anticipating,approve,approved,arise,arisen,arises,arising,ascribe,assess,assigned,assigning,assigns,assume,assumes,assuming,attribute,attributed,attributes,await,awaited,awaiting,awaits,backfire,backfires,backlash,behave,behaved,behaves,behaving,believed,believes,believing,bet,bets,betting,calculated,calculating,call,called,calling,calls,chance,chances,choose,circulate,circulated,circulating,coincide,coincided,coincides,coinciding,condescend,condescending,continue,continued,continues,continuing,counter,countered,courted,danced,dare,dared,dares,daring,develop,developed,developing,develops,disapproved,disapproves,disapproving,disturb,disturbs,essay,essayed,essays,estimate,evaluate,evaluating,expect,expected,expecting,expects,fall,fallen,falling,falls,feign,fell,foreboding,forecast,forecasts,foreseen,foretold,gave,give,giving,gos,guess,guessed,guesses,guessing,hap,hazard,hazards,imagine,intervene,judge,judged,judges,judging,knew,knowing,moved,moving,operated,operates,operating,opined,pass,passed,passes,passing,play,played,playes,playing,plays,predict,predicted,predicting,predicts,prejudge,presume,presumed,presumes,presuming,pretend,pretended,pretending,pretends,proceed,proceeded,proceeds,promise,promised,promises,promising,prophesied,prophesies,prophesy,prosecute,prosecuted,prosecutes,prosecuting,pursue,pursued,pursues,pursuing,rate,rated,react,reacted,reacting,reacts,reading,reckoned,recoiling,recur,recurring,recurs,reject,rejected,rejecting,rejects,repeat,repeated,repeating,repeats,seek,seeked,seeks,sought,strike,strikes,striking,struck,suppose,supposed,supposes,surmise,surmises,suspect,suspected,suspecting,suspects,thinks,transpire,transpired,transpires,transpiring,transported,transporting,travel,traveled,traveling,travelled,travelling,travels,valued,venture,ventured,ventures,venturing,wager,wagered,wait,waited,waiting,waits
SYN390	antidote,application,applications,balm,cured,curing,healing,palliative,remedial,vomit,vomits
SYN391	antihero,antiheroes,believer,believers,enthusiast,enthusiasts,loyalist,mainstay,mainstays,protagonists,stalwart,sympathiser,sympathizer,sympathizers,toaster
SYN392	antiseptic,cathartic,cleaner,cleanest,cleansing,cure,cures,dose,doses,downer,downers,infertile,inhalants,medicine,painkiller,painkillers,pharmaceuticals,physics,powder,powders,prescription,remedy,specific,specifics,sterile,therapeutic
SYN393	antisocial,lone,lonely,recluse,reclusive,unsocial
SYN394	antithesis,confrontation,contradiction,contradictions,contrary,contrast,emphasis,exclamation,foe,opponent,opponents,opposite,opposites,opposition,polarity,repetition,repetitions,tropes
SYN395	antler,foghorn,horn,horned,horns,serpent,serpents,trumpet,tusks
SYN396	antsy,discontented,fretful,itchy,restless,restlessly,tumultuous,turbulent,unsatisfied,whiney,whiny
SYN397	antwerp
SYN398	anus,arse,asshole,assholes,breech,chasms,hiatus,initiatives,motherfucker,mouth,mouths,opening,openings,os,throat,throats,vent,vents,window,windows
SYN399	anvil,block,blockade,blocked,blocking,blocks,cake,cakes,chock,cube,cubes,damed,domino,dominoes,forget,obstructed,obstructing,pulleys,slab,slabs,stirrup,stymied,ward,wards
SYN400	anxious,anxiously,distressed,eager,excitable,flighty,fraught,impatient,nauseous,nervous,overeager,queasy,skittish,spooky,uncomfortable
SYN401	anymore
SYN402	anythings,crackerjack,essentials,freshener,horror,horrors,necessities,necessity,nonentity,requirement,requirements,requisite,somethings,standby,standbys,thing,things
SYN403	apace,speedily
SYN404	apaches,gangster,gangsters,mobster,mobsters,yakuza
SYN405	apartment,apartments,bard,bards,bland,blandest,cabinet,cabinets,camp,camps,condominium,console,consoles,domestic,domicile,dwelling,flat,flatly,flatter,homes,horizontal,housing,insipid,matt,multidimensional,penthouse,prostrate,regressive,shelter,studio,studios,suite,tormenters,tormentor,trappings,unconditional,unexciting,vapid
SYN406	apathetic,bored,dismissive,heartless,impartial,indifferent,listless,spiritless,unbiased,uninterested
SYN407	aped,apes,burlesque,caricature,caricatured,caricatures,charade,copycat,copycats,deride,derides,deriding,emulate,emulating,imitate,imitates,imitating,impersonate,impersonated,impersonates,impersonating,mimic,mimicing,mimicking,mimics,miming,mock,mocked,mocking,mocks,parodied,parodies,parody,parodying,parrot,parrots,ridiculed,ridiculing,sendup,spoof,spoofing,spoofs
SYN408	aperitif,booze,brew,cordial,glycerine,hooch,kava,liquor,perry,perrys,sake,sakes,wine
SYN409	aphrodite
SYN410	aplomb,calm,calmer,calming,chilled,chilling,composure,cool,cooled,cooler,coolest,cooling,cools,hypnotises,hypnotize,iced,lull,lulled,lulls,quiet,reassure,refrigerates,sedated,serene,serenity,stillness,tranquil,tranquility
SYN411	apocalypse,apocalyptic,catastrophe,catastrophes,disaster,disasters,disclosure,discoveries,discovery,giveaway,giveaways,meltdown,plague,plagues,revelation,revelations,tragedies,tragedy,tragicomic,visitation
SYN412	apollo
SYN413	apologetic,apologetically,defensive,remorseful
SYN414	apothecary,biochemist,nurse,nurses,pharmacist
SYN415	apparent,apparently,bemoaning,bemoans,bitching,complain,complained,complains,demonstrable,discernible,evident,evidently,facile,manifest,manifests,obvious,ostensible,patent,patented,patently,plain,plains,seemingly,superficial,unattractive,unmistakable
SYN416	apparition,apparitions,appearance,appearances,banshee,genie,ghost,ghosts,illusion,illusions,jinn,manifestation,manifestations,peri,phantom,phantoms,python,pythons,reappearance,semblance,shade,shades,shadow,shadowed,shadowing,shadows,specter,spectre,spirit,spirits,spook,spooks,ufo,ufos
SYN417	appeal,appealed,appealing,appeals,applied,applies,apply,applying,asked,asks,bankruptcy,beg,begging,begs,bewitched,bewitches,bewitching,blessing,blessings,book,booked,books,captivate,captivates,captivating,challenge,challenged,challenges,challenging,charm,charmed,charming,charms,cite,cited,cites,citing,claim,claimed,claiming,claims,collection,collections,commend,commended,courting,courtship,demand,demanded,demanding,demands,desire,desired,desires,desiring,enamor,enamoured,enchant,enchanting,encore,excused,excusing,foreclosure,hoist,hoisted,hoisting,invite,invited,invites,inviting,invoke,invoked,invokes,invoking,lawsuit,lawsuits,mention,mentioned,mentioning,mentions,petition,petitioned,petitions,plea,pleas,prayer,prayers,procedural,procedure,procedures,proceedings,quest,quests,quote,quoted,quotes,quoting,raise,raised,raises,raising,refer,reference,referred,referring,refers,remember,remembered,remembering,remembers,request,requested,requesting,requests,reserved,reserves,reserving,solicit,suit,suits,supplicate,trance,trial,trials,winsomeness,wooing
SYN418	appeared,appearing,appears,beamed,beaming,bees,befall,befalls,belong,belonged,belonging,belongs,coming,comprise,comprised,comprises,comprising,conduct,conducted,conducting,conducts,consist,consisted,consisting,consists,consummated,consummating,corresponded,corresponds,costing,depend,depended,depending,depends,embodies,embody,embodying,emerge,emerged,emerges,emerging,erupt,execute,executed,executes,executing,feel,feeling,feels,felt,gapes,gaping,glance,gleam,gleaming,glistening,glistens,glitter,glitters,glowing,happen,happened,happening,improvise,improvised,improvises,improvized,inhabit,inhabiting,inhabits,led,leer,leers,lied,lies,looked,loom,loomed,looming,looms,lying,made,make,makes,making,materialize,materialized,materializes,menace,menaced,occur,occured,occuring,occurred,occurring,occurs,overachieve,overachieving,peek,peeks,peep,perform,performed,performing,performs,personified,personifies,personify,practice,practiced,practices,practicing,practise,premiered,premieres,radiate,radiated,radiates,radiating,raged,raging,reared,recite,recites,reciting,rehearsed,rehearses,rehearsing,remaining,remains,represent,scamp,sell,selling,sells,serenade,serenaded,shine,shines,shining,shone,sold,sounded,squint,squinting,squints,stagnate,stagnated,stare,stares,starring,stunt,stunted,stunts,surfaced,surfacing,tend,tended,underachieves,underachieving,underperforming,underperforms
SYN419	appeasement,deprivation,discrimination,domination,duties,duty,enforcement,government,governments,management,obligation,obligations,occupation,penal,penalties,penalty,punishment,punishments,responsibilities,responsibility,soothing
SYN420	appendaged
SYN421	appetite,appetites,craving,stomach,stomachs
SYN422	appetizer,appetizers,cocktail,cocktails,courses,currents,dessert,desserts,eddies,enlistee,enlistees,oozed,path,paths,raceway,seep,seeping,seeps,seminar,seminars,trickle,whirlpool,workshop
SYN423	appetizing,piquant,savory,spicy
SYN424	apple,apples,apricots,banana,bananas,berry,fig,grape,papaya,pear,pears,pineapple,pomegranate,uglies
SYN425	applesauce,barbecue,burrito,casserole,chili,debris,detritus,dish,dished,dishes,dishing,dust,enchilada,garbage,junk,knish,litter,litters,meatballs,meatloaf,omelet,pap,pasta,pizza,pizzas,pudding,rot,rubbish,rubble,salad,salads,scraps,slobbered,slobbering,souffle,taco,trash,trashed,trashes,trashing,tripe
SYN426	applicable,germane,practical,relevant,serviceable,unimaginative
SYN427	appointed,armor,armored,armour,charge,charged,charges,charging,clothes,clothing,commission,commissioned,commissioning,constitute,constitutes,decreed,equip,equiped,equipped,established,fin,fit,fits,fitted,fitting,found,founding,furnished,fuse,fused,fuses,fusing,horseshoes,institute,institutes,instrument,instruments,invest,invested,investing,invests,kit,kits,mechanized,motorized,named,names,naming,nominated,outfit,outfits,outfitted,prescribed,recharge,rename,renamed,rig,rigs,spar,spars,spur,spurred,spurs,stocked,stove,wire,wired,wires,wiring
SYN428	appreciable,considerable,goodly,hefty,respectable,sizable,sizeable,substantial
SYN429	appreciative,eclectic,glad,grateful,selective,thankful
SYN430	apprehend,apprehended,apprehension,apprehensions,arrest,arrested,arresting,arrests,capture,captured,captures,capturing,catch,catches,catching,catchs,caught,claw,clawing,claws,clenched,clinched,clutch,clutches,clutching,collar,collars,compass,comprehend,comprehending,cop,copping,cops,dig,digest,digested,digesting,digging,digs,divined,divining,dug,embrace,embraces,embracing,excavation,figure,figured,figures,figuring,foresee,grab,grabbed,grabbing,grabs,grapple,grapples,grappling,grasp,grasping,grasps,gripped,gripping,hear,heard,hears,hijack,hijacked,interpret,interpreted,interpreting,intuits,ken,kens,kidnapped,nab,nabbed,nabs,nail,nailed,nailing,nails,perceive,perceived,perceives,perceiving,read,reads,savvy,seize,seized,seizes,snatch,snatched,snatches,snatching,tumble,tumbled,tumbles,tumbling,understand,understanding,understands,understood
SYN431	apprehensive,claustrophobic,discerning,discreet,frightened,horrified,incisive,insightful,observant,panicked,panicky,perceptive,precarious,subtle,subtler,tactful,terrified,uneasy,unnerved,worried,worriedly,xenophobic
SYN432	apprentice,beginners,broach,broached,coached,coaching,cub,cubs,cultivating,dispose,disposes,disposing,drill,drilled,drilling,drills,dweeb,educate,educated,educating,fledgling,freshman,gearing,groom,nerd,nerds,newbie,newbies,newcomer,newcomers,novice,prentice,prentices,qualify,rookie,rookies,roughed,savant,starters,train,trained,trainee,trainees,training,trains,tutee
SYN433	apprenticeship,based,basing,behalf,berth,blob,blot,cabaret,caste,catcher,cdc,chair,chairs,crest,crests,crises,crisis,deploy,deploying,directorship,downgrade,environment,environments,equality,equation,faa,forefront,fort,forts,garrison,graves,heights,highs,holy,hotbed,judgeship,junction,lamppost,landmark,landmarks,leadership,lie,lieu,locate,locates,locating,locus,mail,mailing,mails,manhood,mecca,moor,moores,nationality,nightclub,nightclubs,nightmare,nightmares,nightspot,office,offices,outpost,outposts,overlook,overlooks,pedestal,perspective,perspectives,placards,placement,placements,postal,posted,posting,posts,prefecture,presidency,prioritized,prison,prisons,professorship,purgatory,quicksand,rejection,rejections,rendezvous,retirement,sanctuary,scour,send,sending,sends,sheltering,shoes,slot,slots,solitude,soup,spot,spots,spotted,spotting,stance,standpoint,stationed,status,stead,straits,stratum,target,targeted,targeting,targets,throne,tomb,tombs,urgencies,urgency,vantage,vantages,viewpoint,viewpoints,womanhood
SYN434	appropriateness,convenience,correctness,decency,decorum,felicity,grace,graces,modesty,propriety,reserve,rightness
SYN435	approximately,nigh,virtually
SYN436	april,aprils,aug,august,augusts,december,decembers,february,februarys,jan,january,januarys,julies,july,julys,june,junes,mar,nov,november,october
SYN437	apropos,apt,incidentally,opportune,pertinent,suitable,timely
SYN438	aquamarine,azure,beryl,blue,bluer,blues,bluish,emerald,navy,risque
SYN439	aquarium,reservoir,tank,tanked,tanks,terrarium
SYN440	aquatic,endemic,flora,fluid,forest,forests,fungus,implant,implanting,implants,liquid,marines,neophyte,neophytes,ornamental,perennial,submerged,underwater,water
SYN441	aquinas
SYN442	arabia,arabian
SYN443	arachnids,insect,insects,scorpions,spider,spiders
SYN444	aram
SYN445	arbitrarily,randomly
SYN446	arc,arch,arching,arcs,bend,bending,bends,bent,bow,bowed,bows,convoluted,cower,cowering,cowers,crawled,cringe,cringed,cringes,cringing,crook,crooks,crossbows,crouched,crouches,crouching,curl,curled,curling,curve,curves,discharge,discharging,emission,emissions,envelope,excreting,flex,flexes,flexing,gnarled,grovel,groveling,helix,huddle,huddled,meander,meanders,perversion,perversions,rainbow,rainbows,replicate,roulette,spark,sparked,sparking,sparks,spiral,spirals,squirt,stoop,stooped,stoops,twist,twists
SYN447	arcadia
SYN448	arcane,cabalistic,cryptic,esoteric,mysterious
SYN449	archaic,aryan,aryans,barbarians,caveman,cavemans,cavemen,crude,cruder,earlier,earliest,early,incipient,longtime,precocious,primitive,rude,rusty,secondhand,sunset
SYN450	archbishop,bishop,bishops,cardinals,metropolitan
SYN451	archery,athletic,cavorting,comedies,comedy,cycling,featured,featuring,freak,frolicked,frolicking,gymnastics,monstrosity,mutants,mutation,mutations,olympics,preliminary,pun,puns,racing,ridings,romping,skating,skiing,sport,sporting,sports,sumo,wordplay
SYN452	archetypal,eldest,firstborn,initial,introductory,premier,premiere,prototypical
SYN453	archetype,archetypes,balloon,ballooning,balloons,beauties,beauty,epitome,examples,exception,exceptions,framework,globe,globes,humiliation,ideals,instance,instances,kamikaze,kamikazes,mannequins,microcosm,model,modeled,modeling,modelled,modelling,models,original,originals,paradigm,paradigms,paragons,pattern,patterns,pilot,pilots,planetarium,prodigies,prodigy,prototype,quintessential,simulate,simulating,simulation,specimens,supermodel,supermodels,wingman
SYN454	archimedes
SYN455	architect,artist,artistic,artists,builder,choreographer,costumer,creator,creators,designer,designers,developer,developers,farmer,farmers,granger,grangers,landscaper,maker,makers,mastermind,masterminds,originator,producer,producers
SYN456	architectural,architecture,area,areas,arena,arenas,artificially,artistically,assiduously,assuredly,astonishingly,astronomically,atlantic,atmospheric,attractively,audaciously,audited,audits,aurally,authentically,authorial,avidly,awkwardly,badly,baldly,balletic,ballistic,bashfully,bavarian,beautifully,benignly,bewilderingly,billiard,bitingly,blandly,blatantly,bleakly,blessedly,blissfully,boldly,boyishly,bravely,brazilian,breezily,brightly,britisher,brutally,cagily,callously,calvinistic,campus,canadian,canine,capably,catatonic,cautiously,cerebral,characteristically,charmingly,cheekily,cheerfully,cheerily,chivalrously,chronically,chronological,chronologically,cinematic,citizen,citizens,civil,cleverly,climatic,clinically,coarsely,coherently,coldly,collectively,collegiate,colombian,columbian,commercially,commonly,communications,comparatively,compare,compared,compares,comparing,compatriots,competently,complexly,compulsively,conceivably,conceptually,confidently,confrontational,confusingly,consciously,considerably,consistently,contentedly,contextual,continually,contractual,contrastingly,conveniently,conventionally,conversely,convincingly,coolly,cordless,correctly,courageously,covertly,creatively,credibly,crisply,critically,croatian,cryogenic,cuban,culturally,cutely,cynically,dangerously,dauntingly,dazzlingly,deceptively,defiantly,dejectedly,delicately,delightfully,demandingly,demonstrably,demurely,depressingly,deviously,devotedly,diagnosed,differently,dimensional,dionysian,disappointingly,discipline,disciplined,disconcertingly,discouragingly,discreetly,distinctively,divinely,divinity,dolefully,draconian,drastically,drunkenly,dutifully,dystopian,eagerly,earnestly,easily,efficiently,effortlessly,elaborately,electrically,electromagnetic,electronically,embarrassingly,eminently,endearingly,energetically,engagingly,engineering,english,enormously,enslave,entertainingly,enthusiastically,environmentally,eponymous,equitably,erotically,erratically,essentially,ethically,ethnically,ethnocentric,euclidean,evasively,exaggeratedly,excellently,excitedly,expressionistic,expressly,extensively,extraordinarily,fahrenheit,faintly,faithfully,fanatically,fanged,fatally,faustian,favorably,fearlessly,ferociously,fetal,feverishly,field,fielding,fields,figuratively,financially,fiscally,fixedly,flamboyantly,flashily,flawlessly,flexibly,flirtatiously,fondly,foolishly,forcefully,forcibly,formidably,fortunately,franciscan,frantically,freely,frequently,freudian,frontier,frontiers,fundamentalist,futuristic,gainfully,gallantly,generational,generously,genetically,geographically,geologic,geological,gingerly,gladly,gloomily,graciously,gradually,grammatical,graphic,gratuitously,greatly,grotesquely,grudgingly,handheld,handily,harmlessly,hastily,helpfully,helplessly,hemingwayesque,heroically,hesitantly,hideously,hilariously,hispanic,honorably,horizontally,hormonal,humane,humanist,humanities,humanly,humorously,hurriedly,hypnotically,hysterically,icelandic,iconic,ideally,identically,ideologically,idiotically,idly,ignorantly,illegally,illogically,imaginatively,impartially,impatiently,impeccably,imperial,imperiously,impressively,improperly,inaccurately,inadvertently,inappropriately,inauspiciously,incompetently,incompletely,incongruously,inconsistently,inconspicuously,increasingly,incredibly,incredulously,indefinitely,indelibly,independently,indifferently,indignantly,indirectly,indubitably,indulgently,industrial,inelegantly,inextricably,infinitely,infrequently,ingeniously,innately,insidiously,insincerely,insipidly,instantaneously,instinctively,instructional,intellectually,intelligently,intensely,intensively,interestingly,interminably,intermittently,internally,internationally,interstellar,interstitial,intimately,intricately,intuitively,invariably,inventively,involuntarily,irrevocably,israeli,jamaican,jarringly,journalistic,joyously,judicial,jurassic,justifiably,kafkaesque,knowingly,lamaze,lamely,languidly,lawn,lawns,liken,likened,likens,limply,literally,lovingly,luckily,lugubriously,luridly,lustfully,lustily,madly,majestically,major,majoring,majors,maliciously,manchurian,manfully,maniacally,manually,marginally,markedly,martian,mayoral,mechanical,medically,mediterranean,memorably,memorizing,mentally,mercifully,mercilessly,messily,metaphorically,meteorological,methodically,meticulously,mexican,military,minimally,minutely,miraculously,mischievously,miserably,mistakenly,modestly,molecular,monetary,mormon,motionlessly,motivational,movingly,musically,mutually,mystic,mystical,mystically,national,naturally,needlessly,neurological,nicely,nobly,noisily,nominal,nominally,notably,noticeably,objectively,obligingly,obnoxiously,obscenely,obsessively,oddly,olympian,openly,operatic,oppressively,optimistically,orchestral,orthodox,orwellian,ostensibly,outstandingly,outwardly,overbearingly,overtly,overwhelmingly,painstakingly,palatial,palpably,panamanian,paradoxically,parenthetically,partially,passionately,pathologically,patiently,patriot,patriots,pauline,peaceably,pedagogical,penile,perceptively,percussive,perennially,perfectly,periodically,permanently,persuasively,phenomenally,philistine,physically,pitifully,planetary,platonic,plausibly,playfully,pleasingly,poignantly,pointedly,pointlessly,politely,postmodern,potentially,practically,precariously,preciously,predictably,predominantly,presently,presidential,pretentiously,previously,privately,professionally,profitably,profoundly,progressively,promisingly,protectively,proudly,provocatively,psychically,psychosexual,puritanical,purportedly,purposefully,rabbinical,racially,radically,rapidly,rarely,ravishingly,recklessly,recognizably,regional,regrettably,relentlessly,reluctantly,repeatedly,repetitively,reputedly,resolutely,respectfully,responsibly,rhetorically,rightfully,rightly,rigorously,ritual,ritualistic,ritually,routinely,royally,ruggedly,sabine,saharan,salvadoran,samoan,satirically,satisfactorily,satyrical,saxon,scantily,scathingly,science,sciences,scientifically,scots,scottish,secondarily,seductively,selfishly,selflessly,semantic,senatorial,sensitively,sensually,serenely,serial,shakespearean,shakespearian,shallowly,shamelessly,sheepishly,siberian,sikh,silently,simian,similarly,sincerely,singularly,sketchily,sloppily,sluggishly,smugly,societal,sociological,sociopathic,solar,solemnly,soothingly,soviet,spanish,spatial,specifically,spectacularly,spiritedly,spiritualistic,spiritually,sporadically,spousal,startlingly,statistical,steppes,stereotypically,sternly,stirringly,stoic,stoically,stonily,strategically,strenuously,stridently,strikingly,structural,structurally,studied,studies,study,studying,stunningly,stupendously,stupidly,stylishly,stylistically,subconsciously,subject,subjected,subjecting,subjects,subtly,successfully,succinctly,sufficiently,suggestively,sulfuric,superficially,supernaturally,supremely,survey,swedish,swiftly,swiss,systematically,tacitly,tactfully,tactically,tangentially,tantalizingly,tantric,tastefully,tautly,technological,technologically,technologies,technology,tellingly,temperamentally,temporal,temporarily,tentacled,tentatively,terminally,terrestrial,texan,textual,thematic,thematically,theological,theology,thermal,thriftily,tidal,tiered,topic,topical,topics,totemic,toughly,traditionally,tragic,tragically,transatlantic,tribal,truthfully,typically,ultimately,unabashedly,unambiguously,unanimously,unarguably,unashamedly,uncannily,unceremoniously,uncharacteristically,uncomfortably,uncommonly,uncompromisingly,unconditionally,unconsciously,uncontrollably,unconventionally,unconvincingly,undeniably,understandably,understandingly,unduly,uneasily,unequivocally,unerringly,unfailingly,unfairly,unforgivably,unforgivingly,unhappily,uniformly,unintelligently,unintentionally,uninterestingly,uniquely,unjustly,unmercifully,unmistakably,unnoticeably,unpleasantly,unpredictably,unrelentingly,unrepentantly,unselfconsciously,unsuccessfully,unusually,unwillingly,unwittingly,uproariously,urgently,urinary,vaguely,valiantly,vapidly,vastly,vehicular,venetian,veterinary,vicariously,victoriously,violently,vividly,vocally,voluntarily,voyeuristically,weirdly,wholeheartedly,wickedly,willingly,winsomely,wisely,wistfully,wittily,woodenly,wrongfully,wryly,yugoslavian,zealously
SYN457	archive,attract,attracted,attracting,attracts,bank,banks,collected,collecting,collects,culled,funded,garnered,garnering,glean,gleaned,grossed,grossing,libraries,library,museum,museums,mustered,rallied,rallying,reap,salvaged,snail,snails,storage,store,stores,summon,summoned,summoning,treasury
SYN458	arctic,artfully,articulately,aural,autobiographical,automatically,axiomatic,believably,biblical,bitterly,bladed,blindly,bodily,bridal,briefly,brilliantly,broadly,bureaucratic,cannibalistic,capriciously,carefully,carelessly,caroline,casually,celestial,cerebrally,cheaply,chemical,civic,clerical,closely,cockney,cold,colder,coldest,colonial,comfortably,completely,conspicuously,constantly,continental,continuously,cretaceous,criminally,crudely,cultural,curiously,cystic,dearly,decisively,deeply,defensively,deftly,deliberately,deliciously,deliriously,densely,dental,desperately,determinedly,diametric,diametrically,digital,digitally,dimly,directional,directly,distinctly,dogmatic,domestically,dominican,dramatically,dreadfully,dully,ecological,economic,effectively,electrical,electronic,elegantly,elizabethan,emotionally,endlessly,environmental,equine,evangelical,evenly,existential,explicitly,extremely,exuberantly,facial,fairly,falsely,fatalistic,fearfully,feebly,fiercely,finely,formally,frigid,frosty,frozen,furiously,galoshes,generally,generically,genetic,gently,genuinely,geriatric,german,gloriously,gothic,gracefully,graphically,gravely,gregorian,gumshoe,handsomely,haphazardly,happily,harshly,hasidic,hassidic,hawaiian,heartily,heavily,highly,historically,holographic,honestly,hopelessly,humanistic,humbly,hydraulic,icily,icy,illicitly,immeasurably,immediately,implicitly,importantly,impossibly,impressionistic,incestuous,incorrectly,incurably,ineptly,inevitably,inexcusably,innocently,jealously,jokingly,justly,latin,lazily,legally,legitimately,liberally,lifelessly,lightly,locally,logically,loosely,luxuriantly,machiavellian,magnificently,maltese,marine,mariner,masterfully,mechanically,mental,meteoric,mildly,mindlessly,mockingly,moderately,mongolian,monstrously,morally,nakedly,nationally,nazi,necessarily,negatively,nervously,nonchalantly,norman,nuclear,offensively,officially,olympic,optical,outrageously,ovular,painfully,parasitic,pathetically,peculiarly,pentecostal,perpetually,persistently,personally,perversely,pharmaceutical,philosophically,plainly,pleasantly,poetic,polar,political,politically,ponderously,possibly,powerfully,precisely,prematurely,primarily,promotional,promptly,proportionately,prosthetic,protestant,psychologically,publicly,pugilistic,quickly,quietly,raucously,realistically,refreshingly,regularly,religiously,remotely,resignedly,respectably,revolutionary,richly,riotously,roman,romantically,roughly,rubber,sabbatical,sadly,savagely,scriptural,severely,sexually,shakily,siamese,sigmoid,significantly,simply,slightly,slowly,smartly,smoothly,snugly,socially,sorely,soundly,specially,splendidly,squarely,starkly,steadily,stereoscopic,strictly,strongly,substantially,sufi,surprisingly,symbolic,symbolically,sympathetically,tai,technical,technically,tectonic,thai,theatrically,thickly,thinly,thoughtfully,thoughtlessly,tightly,titular,transparently,tubercular,unbelievably,unexpectedly,unnecessarily,unquestionably,unreasonably,verbal,verbally,vietnamese,visibly,voyeuristic,warmly,wildly,wrongly
SYN459	ardor,ardour,bonfire,campfire,eagerness,excitement,excitements,fervor,fervour,fire,fired,fires,firing,infatuation,love,loved,loves,loving,passion,passions,wildness,zeal
SYN460	argentina,argentinian
SYN461	argo
SYN462	arguable,arguably,contentious,controversial,debatable,glib,irrelevant,moot,plausible,problematic,problematical
SYN463	argument,arguments,compendium,conference,conferences,contention,counterargument,debate,debated,debates,debating,declaration,declarations,deliberation,dialogue,dialogues,difference,differences,discrepancies,discussion,discussions,dispute,disputes,divergence,evidence,evidenced,evidencing,firestorm,firestorms,gap,gaps,manifested,manifesting,negotiation,negotiations,overview,polemic,pro,pros,quarrelling,quarrels,resume,resumes,roundup,row,rows,rundown,sparring,statement,statements,summaries,summary,summation,synopses,synopsis,testimonies,testimony,tilt,tilted,tilting,tilts,variable,variant,variants,ventilation,word,words
SYN464	arid,dried,drier,dry,dryer,humdrum,lackluster,lacklustre,monotonous,parched,thirsty
SYN465	aristocracy,chosen,elects,elite,gentry,grandeur,idealism,intelligentsia,nobility,samurai,samurais,social,societies,society,societys
SYN466	aristocrat,aristocratic,aristocrats,bart,cheerleader,cheerleaders,chief,chiefs,chieftain,commander,commanders,employer,employers,guru,gurus,highness,imam,leader,leaders,malik,politician,politicians,politicos,prince,princes,princess,princesses,raja,rajas,superman,supermans,trainer
SYN467	arizona,arizonas,az,draco,uma,uta
SYN468	ark,boat,boating,boats,canoe,canoeing,canoes,darkly,ferry,glumly,lighters,morosely,motorboat,packet,rowing,sullenly,tugboat,yacht,yachting
SYN469	arkansas
SYN470	arlington
SYN471	armada,fleet,fleeting,flits,flitting,swift
SYN472	armageddon,armageddons,assault,assaults,bandied,bandies,batterings,battle,battled,battles,battling,beatings,clash,clashes,collide,collided,collides,colliding,collision,combat,combating,competitiveness,conflict,conflicted,conflicting,conflicts,controversies,controversy,defend,defended,defends,disagreement,duel,dueling,duelling,duels,engagement,engagements,feud,feuding,feuds,fight,fighting,fights,fistfight,fistfights,flounder,floundering,flounders,fought,friction,gunfight,gunfights,gunplay,insurrection,insurrections,intervention,joust,jousting,oppose,opposes,pacification,participation,rebellion,rebellions,resist,revolt,risings,scrap,scuffle,shootout,shootouts,skirmish,skirmishes,slugfest,strife,struggle,struggled,struggles,struggling,tryst,trysts,tussle,tussles,uprisings,wage,waging,war,warfare,warring,wars,withstand,wrestle,wrestled,wrestling
SYN473	armful,basket,bin,bins,bucketsful,carton,crate,crates,fistful,handful,handfuls,headful,jug,keg,kettle,mouthful,pitcher,pitchers,scoopfuls,shovel,shovels,spoon,spoonful,spoonfuls,teaspoons,tub
SYN474	armin
SYN475	armoire,beseeches,booth,booths,closet,closets,compress,convulses,convulsing,crusading,cubicle,insistence,iron,ironed,ironing,irons,knuckle,newspaper,preach,preached,preaches,press,pressed,presses,pressing,pressure,push,pushed,pushing,squash,squashed,wardrobe,wardrobes,weigh
SYN476	armrest,breather,breathers,hibernated,kip,kips,laziness,leftover,leftovers,leisure,remain,remained,remnants,reside,resides,residing,residuals,residue,slumber
SYN477	armstrong
SYN478	arnold,arnolds
SYN479	aromas,bouquet,characteristic,characteristics,incense,nose,nosing,perfume,properties,property,reek,reeks,rental,scent,scented,smell,smelled,smelling,smells,stench,stink,stinks,sweetness,viability
SYN480	arraigned,faulted,file,files,filing,incriminates,incriminating,indicting,lodge,lodged,lodges,lodging,reproach,slandering
SYN481	arrange,arranged,arranges,arranging,authored,barrel,barrels,bed,bedded,bedding,beds,blunted,blunts,bob,bobbing,bobs,bottle,bottles,bucket,buckets,butt,butts,change,changed,changing,clap,clapped,clapping,claps,cocks,coffin,coffins,coifed,coiffed,coifs,compose,composed,composing,concede,conclude,concluded,concludes,concluding,concur,concurs,consort,contemporizing,convert,converted,converts,coordinate,coordinated,coordinates,costume,costumes,cram,crammed,crams,deaden,decorates,decorating,deposit,deposited,deposits,devise,devised,devises,directed,directing,directs,docket,draped,drapes,draping,dress,dressed,dresses,dressing,dulled,dulles,enclosed,establish,establishes,establishing,exchanging,fix,fixed,fixes,fixing,format,forming,founded,gel,gels,gradient,granted,granting,grew,groomed,grooms,grounded,grounding,grow,grown,grows,hairdo,hairstyle,harmonies,harmonizing,harmony,held,hold,holding,holds,inclosed,initiate,initiated,initiates,innovate,insert,inserted,inserting,inserts,install,installed,installing,installs,interspersed,introduce,introduced,introduces,introducing,jar,jared,jarring,jars,juxtapose,juxtaposed,juxtaposes,juxtaposing,juxtaposition,ladles,laid,lay,laying,lays,lean,leaned,leaning,leans,lighten,load,loaded,loading,loads,localized,located,loosened,lose,loses,losing,maintain,maintaining,maintains,manicured,marshal,marshals,middle,middling,misplaced,mount,mounted,mounting,mounts,move,moves,nestled,order,ordered,ordering,orders,organised,organize,organized,organizes,organizing,paragraph,paragraphs,paralleled,paralleling,park,parks,perch,perched,perches,phase,phases,phrase,phrases,phrasing,pigeonholed,pigeonholing,pile,piled,piling,pillow,pioneer,pioneers,place,places,placing,plant,planted,planting,plants,poise,poised,pose,posed,poses,posing,posit,positing,position,positioned,positioning,positions,posits,post,posture,prepare,prepared,prepares,preparing,put,puts,putting,ranks,rationalize,rearrange,rearranged,recess,reclining,reconcile,reconciles,reconciling,replace,replaced,replaces,replacing,reset,rest,rested,resting,rests,rewrite,rewrites,rewriting,rewritten,rigged,sat,scripting,seat,seated,seats,seed,seeds,serialised,serialized,set,sets,setting,settings,settle,settled,settles,settling,shelve,shelved,shelves,shift,shifted,shifting,shifts,ship,shipped,shipping,ships,sign,signed,signing,signs,siphoned,sit,site,sites,sits,sitting,situated,situation,situations,snuggles,snuggling,sow,space,spaced,spaces,spacing,stacked,stacking,stage,stages,staging,stand,standing,stands,station,stations,stepped,stepping,stood,straighten,straightened,straightens,stringing,structuring,strung,stuck,subscribe,subscribed,superimposed,supporting,synchronised,synchronized,tee,teed,threw,throw,throwing,thrown,throws,thrust,thrusting,thrusts,transform,transformed,transforming,transforms,transpose,transposed,transposes,transposing,trench,trenches,upending,wave,waved,waves,waving,write,writes,writing,written,wrote
SYN482	arrogance,conceit,condescension,dignities,dignity,ego,egos,egotism,haughtiness,hauteurs,hubris,pride,prided,snobbery,snobbishness,superiority,vanities,vanity
SYN483	arrogant,boastful,conceited,disdainful,egotistic,egotistical,haughty,illustrious,persnickety,redoubtable,snooty,snotty,supercilious,vain
SYN484	arrow,arrows,badge,badges,brand,branded,bullet,bullets,calibrated,characterize,characterized,characterizes,characterizing,chump,commemorate,distinguish,distinguishes,ditto,footprint,footprints,hallmark,hallmarks,lined,mark,marked,marker,markers,marking,markings,marks,milestone,narrowly,patsy,pellets,pointer,pointers,punctuate,scar,scarred,scarring,scars,score,scored,scoring,scribe,seeker,seekers,sidewinder,slug,slugs,starred,stigma,tick,ticks,trademark,trademarks,underline,underlined,underlining,underscore,underscored,underscoring
SYN485	arsenal,inventory
SYN486	arsenic,audio,brs,carbon,chlorine,component,components,db,ds,element,elements,equally,helium,hes,hydrogen,ingredient,ingredients,krypton,md,metal,mt,ne,neon,nitrous,oxygen,phosphorus
SYN487	art,artistry,arts,artwork,aviation,carving,carvings,classics,creation,creations,drawings,erotica,graphics,illustration,illustrations,innovation,innovations,kitsch,origami,painting,paintings,porn,porno,pornography,pornos,porns,production,productions,prowess,puppetry,sculpture,sculptures,topiary,triptych
SYN488	arthur,arthurian,arthurs
SYN489	artifice,assist,assists,blitz,blitzes,channeled,channeling,completion,conn,cornered,device,devices,docked,feints,gambit,gimmick,gimmicks,guided,icing,jockey,maneuver,maneuvering,maneuvers,measure,measures,mousetrap,navigate,navigated,navigating,obstructions,operate,parked,parkes,parking,piloted,ploy,ploys,ruse,ruses,steering,tactic,tactical,tactics,tree
SYN490	artificial,bleached,cardboard,celluloid,contrived,counterfeit,dummies,dummy,dyed,fake,faked,fakes,faking,false,faux,hokey,imitation,imitations,nearer,nearest,sham,simulated,staged,stilted,stylized,substituted,substitutes,synthetic,unnatural,unreal
SYN491	artificiality,pretension,pretensions,pretentiousness
SYN492	artillery,batteries,cannon,cannons,catapults,cavalry,corps,firearm,firearms,flamethrowers,gun,gunman,gunmen,gunned,guns,hatchets,infantry,knives,launcher,launchers,missile,missiles,persuasion,persuasions,platoon,platoons,projectile,prompting,sentiment,sentiments,slasher,slashers,squad,squads,suggestion,suggestions,sword,swords,tomahawk,troop,troops,weapon,weapons
SYN493	artisan,aviator,aviators,baker,bakers,beautician,butcher,butchers,cook,cooper,coopers,craftsman,craftsmen,crewman,crewmen,cutter,discoverer,discoverers,dyer,editor,editorial,editors,electrician,fisher,fisherman,fishermans,fishermen,founder,founders,functionary,glazers,grip,grips,hairdresser,hairstylist,hunter,hunters,inventor,inventors,journeyman,lineman,machinist,machinists,mason,mechanic,mechanics,miller,millers,mortician,official,officials,painter,plumber,potter,potters,projectionist,roper,sailor,sailors,serviceman,shearer,skinner,smith,smiths,stylist,tanner,tanners,technician,technicians,thrower,turner,turners,wallpaperer,weaver,weavers,welder,woodman,wright,wrights
SYN494	artiste,comedian,comedians,comic,comics,cowboy,cowboys,dancer,dancers,geek,geeks,headliner,illusionists,magician,minstrel,minstrels,musician,musicians,performer,performers,player,players,puppeteer,puppeteers,stripper,strippers,striptease,strongman,thespian,thespians,vaudevillian,ventriloquist
SYN495	arty,grandiose,overblown,pompous,portentous,pretentious,upstart
SYN496	asbestos
SYN497	asexual,asexually,breakaway,sexless,unsexy,vegetative
SYN498	ashamed,discredited,disgraced,embarrassed,guiltily,guilty,humiliated,mortified,shamed,sheepish
SYN499	ashe
