WP	harshly,humble,discredit,low,rence,vilify,disrespect,sharply,degradate,revile,despise,abase,undervalue,hector
KA	renounce,prorude,hostile,stipulations,stubborn,waygive,contentious,secure,knees,overcome,halfway,retaliate,trap,promises,rights,aback,crash,correspond,rampage,hammer,abate,outdo,cushion,coals,risks,accomplish,sequester,tactics,peg,cause,second,devolve,sap,bully,fortify,hands,illwill,enlist,circumvent,tether,remedy,refrain,outsmart,pleasure,enfeeble,hair,fight,guard,molest,stay,pact,oust,distance,contradictory,bold,inferior,regain,sidejump,bulldoze,hard,requisition,difference,confuse,lccb,torpedo,detain,hatchet,bygones,struggle,thrust,minimize,kindly,defeated,floor,counterarguments,swallow,step,quickwitted,loosen,impudent,acrid,undermine,partly,breach,persevere,involve,compact,strut,round,packing,kindle,fighting,arrangements,tired,blurt,affront,malicious,shelf,horns,defuse,hop,lurch,pluralistic,sulky,lower,hopes,previously,depend,enervate,irreconcilable,entrap,antechambers,animate,joyful,capitulate,war,obviate,shake,pretensions,atone,blandish,harmonize,cohere,grouse,slight,small,self,push,puzzle,toes,compete,untie,obtain,prevaricate,conttnd,subjugate,safeguard,bluntly,certain,neutralize,harm,shoot,en,yielding,inveigle,gobetween,furios,recalcitrant,intimacy,checkmated,united,poison,clearly,gloat,rummage,parry,possession,meddle,wrest,thether,simulate,backbite,resignation,dillydally,bury,bicker,trump,stipulate,squirm,concessions,arrest,reconciled,disarm,direction,behalf,granted,redress,grass,harden,elude,misfortune,unknown,anxiety,placate,league,grudge,tally,forsake,trumps,murmur,loggerheads,agitate,foreign,sink,everything,curtail,sweep,unawares,terrorize,respond,prtly,loose,defy,drop,acquaintance,deescalate,infiltrate,ruin,torment,sidestep,bar,atmosphere,oppress,disconnect,quieten,boycott,undo,bump,strange,retreat,triumphant,different,ally,implacable,great,harmony,compliant,tactic,relax,prompt,news,subversively,reservations,unintentionally,resigned,bargain,concur,debilitate,preclude,coat,behind,depart,cheat,best,relent,sanction,dare,haggle,surpass,wrangle,protection,redeem,checkmate,succumb,devaluate,mouth,objections,scrape,peace,enemy,coalition,phasize,bindly,curb,querulous,relations,venture,resignate,reclaim,stick,encircle,rejoin,frighten,sossails,thunderstruck,triumph,abstain,side,outshine,sides,negotiate,shelve,oblivion,stabilize,pleased,appear,repay,assist,flexible,mask,dismantle,jog,buck,wangle,lie,presuppositions,stir,sharpen,background,sacrifice,shift,interes,benevolent,blindly,unsettled,camouflage,sight,brave,expostulate,sabotage,overthrow,embolden,feet,liberty,plug,settlement,soundings,referee,pry,disable,flight,employ,tune,overthrown,overrule,overtures,reach,jolt,rake,satisfy,yes,thinking,win,retard,polemize,interested,longer,corner,lodge,clever,adulate,skids,represent,edify,delighted,insistently,importance,skirmish,counter,scrub,overturn,backing,paralyze,cap
IN	orientation,insure,some,anonymously,associate,impugn,forgotten,query,fudge,firmly,extrude,identity,extract,orient,disperse,removal,bulletin,somebody,message,arrive,detect,psychoanalysis,perfotm,mindful,abbreviate,disentangle,affix,diffuse,filter,compute,divine,slant,case,abbreviation,elicit,rumors,advertise,deprecate,witnesses,valuate,regularly,remember,assevere,discover,affidavit,police,aware,search,equal,unravel,particulars,pseudonym,spurn,asseverate,hypothesize,recollect,occur,aver,solve,censor
DE	synthesize,presuppose,amass,attempt,collate,daydream,balance,compile,assumption,surprised,dispose,conceive,cogitate,ranks,doubt,imagine,postulate,rank,accumulate,greatly,preference,meditate,generalize,opine,parallelize,backwards,divide,expect,concatenate,assemble,concentrate,abduce,rationalize,wonder,objectivize,scheme,carefully,resolve,astonished,brook,muse,exclusion,assume,analyze,construe,deduce,pillow,lost,absorb,collect,hope,speculate
KANOWP	outrage,abuse
NO	duty,closely,partnership,obligate,cashier,taboo,responsibility,adopt,crown,null,seized,stigmatize,expatriate,acquittal,custody,ban,canonize,impudence,legislate,guardian,confederation,antedate,forbid,leniency,entitle,misdeed,banish,fire,should,consign,treaty,tutelage,oblige,fine,forgive,priest,denunciate,imprison,blunt,guilt,conflicting,knight,duties,excommunicate,liberate,inculpate,underpin,dissolve,conspiracy,suspicion,suitable,credential,condone,discard,obligation,lawsuit,age,child,debt,supersede,amnesty,exculpate,occupy,alleviate,marry,postdate,deprive,abolish,revolt,rehearing,inaugurate,misdemeanor,charge,enrole,conspire,citizenship,disband,commit,regret,inflict,clinch,penalty,arbitration,warning,sentence,legal,interdict,accuse,proscribe,law,relegate,promote,guilty,maledict,vow,frank,blaspheme,indict,pardon,remorse,transact,violate,constitute,crossexamine,infringe,deputate,removeaguiit,execute,discipline,matriculate,privilege,penancedo,absence,argumen,consensus,innovate,penance,mercy,hire,legalize,degree,dispel,litigate,exonerate,censure,damm,ennoble,exile,obliged,cede,doubts,abscond,extradite,impolite,absolve,divorce,justify,prospect,disqualify,expiate,release,regulations,rusticate
IINO	abrogate,depose
DEETTO	perceive,abstract
IR	chaff,jibe,tease,absurd,puns,pun,repute,lao,irony,foolish,imbecile,caricature,lark,leg,game,persiflage,sport,frolic,hoax,silly,practical,gibe,slur,someone,taunt
EN	entreat,amaze,conditions,bid,opress,ro,favorably,embarrass,educate,dedicate,happens,beseech,astound,donation,advanceorderin,preside,gestures,guesses,buttonhole,alarm,allay,daunt,courage,assuage,motivate,inquire,depress,balk,arouse,lend,infatuate,excite,consult,remit,prescribe,money,annex,seat,remind,rescind,bait,begging,distress,contravene,bother,mans,fulfill,quiz,instigate,hearing,suggestion,intrust,decoy,condole,purpose,propaganda,sicken,spur,questions,entreaties,commandeer,appointment,lurk,bewilder,influence,expropriate,forget,suggestions,run,wake,dishearten,enliven,excited,bill,calion,enthusiasm,mislead,debar,bestow,disposal,inculcate,sale,astonish,disgust,flabbergast,accordingly,disconcert,danger,allure,exhort,we,awake,coerce,dispossess,tempt,startle,inquiry,create,questioning,orders,supplicate,donate,warn,discourage,sympathize,drum,alert,negative,compel,obtrusive,forgiveness,distrain,assignment,dictate,subsequently,eject,quiet,will,affirmative,watch,mission,sidetrack,divert,directions,waken,doing,layaway,commiserate,cooperate,defeat,inspire,await,afflict,accede,negatively,solace,stagger,propagandize,disquiet,convince,prime,console,convert,giving,disinherit,threatening,endeavor,rise,solemnly,repulse,bequeath,delude,intimidate,interview,lull,distract,commission,brief,dispatch,property,attend,assign
TO	chain,solidify,bypass,relief,dissect,differently,prominence,highlight,interlard,reorder,transform,foreground,limelight,except,tackle,accent,sequence,lightly,steer,couple,succession,paragraphs,embrace,verbalize,alter,accentuate,subdivide,brackets,emphasize,polite,construct,entwine,statement,greatest,stress,bind,partition,salient,widen,hit,extemporize,spot,splice,transpose,enclose,embed,casually,parentheses,remodel,spotlight,conglomerate,ease,interlace,rearrange,bracket,graze,invert,repetitive,contrast,layout,patch,interweave,compress,sore,series,expand,s
ENKANO	well,apologize,demand,full,appease,court,resign,part
DI	participation,cleverly,wanted,debatediscussion,convoke,feelers,counteract,converse,trouble,dence,encounter,brilliantly,inhibit,amuse,jam,invitation,giftedly,entertain,running,masterfully,discourse,chairman
DIENKA	gain,upset,interest,accost
DIKANO	settle,arrangement
ENIINO	bail,writing
INVVWT	receipt,evaluate,appraise
INNO	post,repeal,withdrawal,acquit,crime,pump,pulpit,found,convict,bills,ensure,excuse,witness
ET	overt,memorize,mechanically,tongues,copy,spoonfeed,poetry,experiences,model,knowledge,exposition,glossolalia,prophesy,ejaculate,ramble,instead,rewrite,purple,taste,mimic,pronounce,forecast,prognoses,predict,leaves,exam,imitate,explicate,practice,gratify,cable,fathom,memorialize,indoctrinate,diary,fiction,manners,rhymes,proofs,documents,worse,predestine,better,shorten,trim,trade,retouch,drill,justification,comprehend,acquire,anew,sugarcoat,treaties,minute,fishstories,delirious,tricks,lengthen,proofreading,realize,psalms,understanding,how,bare,tes,rework,idly,exercise,afresh,field,prose,tarot,rote,reason,polish,restore,fortunes,prognosticate,foretell,explanation,why,pad,concise,enlighten,exclaim,publicize,predestinate,preplan,predetermine,register,conviction
ENNO	disobey,depute,interrogate,move,regulate,browbeat,void,ordain,conduct,obey,require,warrant,permit,expel,empower,petition,astray,application,delegate,quash,award,train,solicit,tho,motion,institute,command,mandate,powers,sue,seize,enact,happen,govern,pledge,woo,manipulate,chairmann,license
TE	paraphrase,printing,misjudge,study,retail,text,distorted,encipher,counterfeit,laud,tear,purport,distoted,adapt,exegesis,books,redefine,dispense,retell,passages,browse,retranslate,popularize,reshape,misinterpret,excerpts,glance,reinterpret,inspect,imprint,forge,interpret,disfigure,fail,misnomer,satirize,original,transcribe,translate,abstracts,poor,edit,recreate,anglicize,misread,interpretation,perform,err,peruse
EM	angrily,sorry,cry,moan,pout,sob,forwith,stage,grin,chill,hissingbooing,abruptly,angry,suddenly,dawdle,red,imperiously,bitch,joy,breathe,sanctions,nervous,fidget,hate,spit,stutter,teeth,stammer,rage,shocked,boo,uncomfortable,cuss,vexed,grimace,sad,growl,lament,shriek,am,snap,evil,explode,mourn,snarl,tremble,gladden,salute,admire,thunder,maledictions,damn,rumble,grateful,heavily,clap,worried,shout,pale,curse,laughing,had,whimper,blush
AV	exemplify,example,paradigm,validation,quote,lay,antithesis,sustain,endow,adversely,deleterious,furnish,critique
KANOTV	right,restrict,adhere,obstinate,undecided,defend
TV	excursion,standardize,stmately,actual,qualify,muddle,concrete,live,cling,recommence,commence,overview,renew,defer,reiterate,elegy,detailed,obstinately,retrospect,borrow,chew,reappear,explicit,reenter,majority,usher,muddled,append,transition,thread,premise,lose,vary,ventilate,preliminarily,prematurely,preliminary,viewpoint,develop,diverge,recur,interject,pluck,proceed,beforehand,checklist,wall,afterthought,air,synopsis,behfud,ahead,subjoin,having,undertake,confused,recapitulation,brick,previous,onupon,theme,past,deviate,amplify
VV	bibliography,rechristen,alphabetize,sift,seal,ticket,signet,typify,contemplate,figures,locate,dub,undersign,schedule,characterize,style,backdate,nickname,lexicalize,rename,provisionally,underwrite,inscription,inventory,legend,tabulate,designate,number,allot,assay,catalogue,pages,denominate,adjoin,baptize,grade,rubrify
DIKATUTV	intervene,interpose,adjourn
KATV	objection,stand,one,straight,adjust,deal,unify,maintain,delay,treat,return,exhaust,complete,contradiction,procrastinate,track,persist,own
ENWT	advice,complain,caution,sanctify,admonish,commend
EMNO	p,grieve
TP	rousing,provisos,noticed,romanticize,sleep,greet,illustrate,hoodwink,mix,gibberish,grace,overdo,raving,leo,misrepresent,adorn,straws,indistinctly,envelop,lavish,succinctly,woolly,confound,tighten,phrase,graduate,transcend,extenuate,dead,blurred,metaphors,vaguely,gibber,flog,secrete,jabber,flounder,transfigure,stylize,pretentiously,brilliant,cryptic,disorder,detract,fragmented,bungle,banalize,cloud,bore,subtle,disguise,pompously,veil,drivel,stuff,idealize,sparingly,analogize,context,pessimistically,superficial,shallow,vulgarize,hackneyed,simplify,disarrange,moving,bosh,singsong,contort,far,adulterate,farfetched,estheticize,stitle,bright,pervert,mechanical,audience,involved,rehearse,expansively,fluous,poeticize,mingle,economize,hazily,prattle,obscure,soundly,metaphorize,idyllize,enthusiastic,bombastically,formula,allegorize,waste,overact,horse,distort,spoil,illustrative,cloak,luxuriate,distinguished,bookish,us,tint,stereotyped,inflate,dramatize,enthuisiastic,stirring,chat,complicate,deform,indefinitely,warp,monotonous,botch,boring,palliate,swell,ab,blend,demystify,symbolize,balderdash,fragmentary,broken,disconnectedly,trifle,withhold,blabber,outstanding,excess,personify,blather,belittle,ignorance,hedge,twaddle,gossip,indifference,shade,herorize,intricate,repeating,tangle
ETNO	tales,advertize,apprehend
ENKAWT	dissuade,advise
ENINKANO	answer,guarantee
ETINNO	proclaim,oath
EMKA	glad,enough,furious,vent,squabble,afraid,whine
ETTE	learn,reproduce,popular,read,paper,new
AVKA	rebut,views,argue,arguments,confute
TU	announced,silent,finish,chance,alternate,throttle,cutin,forego,anhc,filibuster,chime,dumb,falter,hom,dumbgrow,dump,overlook,tongue,monologue,remain,concisely,rush,disrupt,short,sosa,discontinue,pause,schematize,continuing,my,edgewise,namecard
ETKA	see,aid,iterate,feel,exchange
KANO	arbitrate,resist,insult,amends,seriously,reply,alliance,quit,rebel,recruit,revenge,desert,humor,vindicate,retort,business,payoff,agreement,compensate,requite,offend,secede,spare,decision,discharge,engase,thing,tolerate,colors,effect,office,fault,wrong,intercede,provoke
ENTO	allude,attract,touch,bcb,focus
DITV	stagnate,flowing,prelude,topic,preface
DETO	articulate,files,combine,link,amalgamate,subsume,juxtapose,comprise,systematize
ETIN	testimony,transmit,bottom,advertisement,announce,coin,testify,telegraph
DIINNO	retract,annul
ENKA	urge,lure,frustrate,restrain,reserve,contact,encourage,press,supply,soothe,canvass,wait,seduce,react,entice,baffle,incite,worry,succeed,services,blackmail,stimulate,menace,rouse,hinder,cajole,confiscate,deter,surprise,comfort,repel,thwart,calm,demoralize,importune,threaten,persuade,goad,scare,exact,pacify,submit,extort,insist
DETV	anticipate,derive,design
EMWT	toast,exultation,rejoice,applaud,cheer
DIEN	enforce,invite,apply
ENNOVV	book,appoint
DIDT	discussion,chattering,time
ENKANOWT	approve,plead,hold,promise,dismiss
KATUTV	postpone,continue,pursue
AVETTP	illumine,produce,illuminate
WS	overweering,usurp,bushel,snob,loud,fraud,parade,understate,selfeffacing,swindle,swagger,arrogate,purseproud,overly,overbearing,modest,ridiculous
WT	prejudice,extol,exalt,worship,prize,esteem,hiss,amiss,homage,ballot,thorough,degrade,shred,celebrate,idolize,cencure,merits,errors,factors,pigeonhole,disapprove,respects,revere,congratulate,deplore,high,prejudices,fraternize,disfavor,allegiance,ascribe,vote
DEEN	gather,induce,thoughts,intend,receive,aspire,prefer,desire,long,believe
INKA	assail,disown,penetrate,attack,contest,negate,repudiate,true,ground
INVV	sort,assess,stamp,index,sure,categorize
DEET	assimilate,project,francis
DTENWSWT	compliments,pay
TOTP	intimate,omit,attenuate
WPWT	reprimand,upbraid,attribute
INWT	certify,certificate,bias,document,te,group
DTTP	nonsense,split,hairs,stories,babble
DEKATO	work,consideration
VE	confidence,stiff,your,trumpet,whisper,blab,pony,letters,communicate,cell,tap,overhear,plagiarize,spill,prisoners,smuggle,confide,clandestinely,eavesdrop,bag,treason,againston,crib,entrust,unbosom,unearth,cribshead,beans,eavesdropping,whistle,sworn
NOWT	meeting,distrust,status,conference,rebuke,reputation,punishment,resentful,highly,elect,reprove,beatify,blame
KAVV	cross,position
EMEN	severe,sympathy,pity,love,disappointed
KAWT	done,rely,exult,favor,disagree,respect,carp
EMKAWT	face,grumble
DITUTV	terminate,begin,interrupt,speaking
ENTP	favorable,manner,much,pray
DITU	stuck,protract,prolong,goodbye,conclusion,struck,cut
DENO	distinction,suspicious,above,suspect
NOVE	secret,betray,confession,denounce,society
DT	shop,obscenities,lewd,pettifog,gaggle,bawdy,huckster,smut,philosophize,expense,quack,gabble,dirty,smutty,fourletter,speakers,theoretize,obscene,paint,expensebe,acquisition,theologize,filthy,cackle,indecent
TPWS	big,brag,boast
TETP	old,murder
ENET	brainwash,strike,cram
NOVV	christen,brand,label,term,countersign,misdate
AVKANO	argument,refute
AVINNO	contradict,proof
KATP	shirk,cover,squash,confusion,entangle,hide,twist,crush,silence,trivialize,suppress,dodge
DIKATU	end,cease,desist
ETKATV	repair,again
KATU	butt,become
NOWP	calumniate,outlaw,defame
ENKAWS	captivate,wheedle,fascinate,coax
TOTV	enlarge,delimit,mention,profile,demarcate,making
DTENWS	charm,sweet
INTV	thoroughly,recall
INTE	distribute,circulate,meaning,propagate,disseminate,decipher,decode
ETKATP	formulate,clear
ENKATP	manage,too
INKANO	lb,combat,confess,fix,contract
DIKA	rebuff,close,harass,participate
ENETKA	prepare,head,help,that
EMNOWT	scold,offense
KAWP	intrigue,humiliate,compromise,flee,vex,slander
KANOWT	bbi,concede,his
TETV	reconstruct,pull,gloss,condense,recapitulate,review
DEIN	think,conjecture,surmise,look,insinuate
DEKA	suppose,fear,mto
DIDTKATV	contribute,debate
ENVE	listen,school
ENKANOTO	oppose,guide
DEVV	coordinate,discern
ENIN	pupils,lesson,countermand,examine,investigate
DTTPTU	portray,declaim
TPWT	glorify,decorate
INTO	define,trace
DIENKANO	deny,follow
IRKA	deride,fool,dupe
DEINKAVV	determine,separate
DEDTVE	hatch,devise
KATO	diminish,alone,include,place,eye
TPTV	shape,digress,precise,stretch
ETNOVE	disclose,uncover
TPWP	shun,disparage
INNOVE	evidence,divulge
TEVV	encode,falsify,laa
ETTV	improve,elaborate,perfect,progress,draft
ETTP	sermonize,untruths,rave,forth,embellish
DINO	encroach,prohibit
DEETVV	something,record
KAWS	ensnare,pretend
ETVV	trough,cards
TOVV	enumerate,incorporate
KAVE	shut,sing,know,escape
NOTO	subordinate,modify,exempt
DTET	anothers,narrate
DENOWT	judgement,judge
DIIN	recant,explore
ETVE	expose,reveal,unveil
ENWS	behave,extravagantly,familiar,flatter
DEETTP	indulge,yarns
DTWS	nothings,flirt
ENTV	strengthen,frame
DETE	infer,wool
TVVV	specify,title,heading
ENNOWT	propose,nominate,honor
NOTU	relieve,permission
EMET	voice,you,utter
ISTO	handle,forefront
EMWP	scream,heckle
IRWP	ill,laugh,scoff,scorn
ETTO	improvise,state
ENWP	shock,irritate
DTIR	jokes,joke,jest
DIENNO	offer,l
KATE	mediate,misunderstand,mistake
DTETTP	relate,moralize
DEETTV	note,plan
DEISTO	organize,segment
ENKATU	waive,relinquish